id;subject_id;student_id;teacher_id;att1;att2;exam;total
1;1;151301;7;19;13;48;80
2;1;180101;1;14;6;35;55
3;1;180501;3;13;9;43;65
4;1;180701;3;18;9;34;61
5;1;180201;9;10;17;13;40
6;1;180301;8;20;6;18;44
7;1;151501;8;18;14;16;48
8;1;170901;3;9;19;44;72
9;1;151302;7;10;12;31;53
10;1;180801;4;15;5;47;67
11;1;181001;5;10;9;28;47
12;1;180102;1;15;15;7;37
13;1;180401;10;19;17;25;61
14;1;180502;3;17;5;48;70
15;1;180202;9;18;8;12;38
16;1;180302;8;17;10;27;54
17;1;180601;1;12;10;43;65
18;1;180303;8;14;13;34;61
19;1;180402;10;11;19;28;58
20;1;180702;3;6;7;7;20
21;1;180103;1;11;13;50;74
22;1;170902;3;15;18;16;49
23;1;180203;9;12;12;22;46
24;1;180802;4;19;12;27;58
25;1;180503;3;6;13;11;30
26;1;180304;8;11;14;50;75
27;1;180403;10;16;13;38;67
28;1;180602;1;6;11;51;68
29;1;180703;3;18;5;12;35
30;1;151401;6;15;5;30;50
31;1;180104;1;16;6;26;48
32;1;170903;3;10;17;56;83
33;1;180105;1;17;7;34;58
34;1;180204;9;17;17;25;59
35;1;180305;8;13;6;27;46
36;1;170904;3;14;18;30;62
37;1;180404;10;9;5;29;43
38;1;180106;1;9;19;17;45
39;1;151303;7;18;20;53;91
40;1;181002;5;17;18;17;52
41;1;180704;3;10;13;35;58
42;1;151402;6;19;9;44;72
43;1;180504;3;6;19;30;55
44;1;151304;7;20;5;25;50
45;1;151502;8;8;9;41;58
46;1;180705;3;14;11;25;50
47;1;180603;1;17;20;37;74
48;1;180803;4;11;19;22;52
49;1;180306;8;12;20;7;39
50;1;151503;8;5;11;6;22
51;1;180205;9;15;15;60;90
52;1;170905;3;18;13;6;37
53;1;181003;5;9;14;52;75
54;1;180405;10;8;9;58;75
55;1;151305;7;7;9;11;27
56;1;180307;8;16;8;41;65
57;1;181004;5;8;7;12;27
58;1;180406;10;16;14;27;57
59;1;180505;3;10;19;26;55
60;1;170906;3;15;8;18;41
61;1;180604;1;20;5;41;66
62;1;180308;8;9;7;8;24
63;1;151403;6;6;9;49;64
64;1;180206;9;20;16;35;71
65;1;180407;10;10;6;49;65
66;1;180706;3;17;6;19;42
67;1;180107;1;6;19;25;50
68;1;180804;4;18;11;28;57
69;1;180207;9;7;15;46;68
70;1;151504;8;20;8;32;60
71;1;180408;10;9;5;16;30
72;1;170907;3;20;6;19;45
73;1;180108;1;19;12;26;57
74;1;180309;8;18;13;5;36
75;1;181005;5;17;13;47;77
76;1;180605;1;19;20;28;67
77;1;180109;1;7;14;19;40
78;1;151306;7;20;8;38;66
79;1;180707;3;5;17;49;71
80;1;180110;1;14;8;21;43
81;1;180409;10;5;16;55;76
82;1;170908;3;17;19;18;54
83;1;180506;3;6;17;42;65
84;1;180606;1;19;17;45;81
85;1;151404;6;15;14;46;75
86;1;180805;4;13;8;28;49
87;1;151505;8;11;6;21;38
88;1;180410;10;14;9;58;81
89;1;151307;7;20;16;6;42
90;1;180310;8;7;17;40;64
91;1;170909;3;16;19;19;54
92;1;181006;5;17;20;53;90
93;1;180111;1;6;12;10;28
94;1;170910;3;20;12;52;84
95;1;151506;8;18;18;12;48
96;1;180311;8;9;18;33;60
97;1;180112;1;14;13;54;81
98;1;180708;3;19;6;32;57
99;1;180507;3;20;7;13;40
100;1;180607;1;11;8;45;64
101;1;180709;3;13;13;58;84
102;1;180806;4;8;16;6;30
103;1;181007;5;7;16;21;44
104;1;180411;10;16;10;22;48
105;1;180208;9;15;12;21;48
106;1;180312;8;7;14;12;33
107;1;180412;10;12;19;21;52
108;1;180113;1;19;20;9;48
109;1;181008;5;15;8;27;50
110;1;180508;3;9;18;27;54
111;1;151308;7;15;9;13;37
112;1;151405;6;17;8;12;37
113;1;180608;1;9;11;23;43
114;1;151507;8;7;19;58;84
115;1;180209;9;12;9;58;79
116;1;180313;8;13;5;32;50
117;1;180413;10;8;8;11;27
118;1;180114;1;14;14;36;64
119;1;180210;9;13;7;7;27
120;1;180710;3;11;11;9;31
121;1;180807;4;15;18;23;56
122;1;180211;9;20;15;17;52
123;1;180115;1;5;5;39;49
124;1;180212;9;17;20;43;80
125;1;180414;10;19;6;19;44
126;1;180314;8;12;18;52;82
127;1;180213;9;8;9;56;73
128;1;181009;5;6;17;53;76
129;1;180509;3;9;15;54;78
130;1;180808;4;16;18;33;67
131;1;180415;10;11;13;39;63
132;1;180609;1;16;16;22;54
133;1;151406;6;16;6;27;49
134;1;151508;8;13;20;30;63
135;1;180116;1;10;12;48;70
136;1;180315;8;9;19;32;60
137;1;181010;5;17;17;10;44
138;1;180416;10;11;8;32;51
139;1;180117;1;11;8;30;49
140;1;170911;3;20;16;20;56
141;1;180610;1;10;13;6;29
142;1;170912;3;19;14;32;65
143;1;180711;3;12;14;47;73
144;1;170913;3;6;11;57;74
145;1;180809;4;13;8;14;35
146;1;181011;5;7;18;24;49
147;1;170914;3;15;20;8;43
148;1;180214;9;11;14;55;80
149;1;180316;8;5;18;39;62
150;1;170915;3;12;15;39;66
151;1;151309;7;9;5;60;74
152;1;151407;6;15;18;12;45
153;1;180510;3;12;10;44;66
154;1;151509;8;19;5;56;80
155;1;151310;7;20;18;10;48
156;1;180215;9;19;14;21;54
157;1;180611;1;19;15;16;50
158;1;180712;3;6;18;29;53
159;1;180810;4;16;10;50;76
160;1;181012;5;9;20;47;76
161;1;180417;10;20;12;43;75
162;1;151408;6;6;5;44;55
163;1;181013;5;10;19;28;57
164;1;151510;8;18;8;28;54
165;1;151311;7;18;7;16;41
166;1;180811;4;6;18;53;77
167;1;180511;3;13;8;8;29
168;1;151409;6;17;10;20;47
169;1;180612;1;20;17;59;96
170;1;170916;3;15;20;36;71
171;1;180713;3;19;8;35;62
172;1;180812;4;19;7;12;38
173;1;180118;1;15;17;53;85
174;1;181014;5;15;8;59;82
175;1;180418;10;5;20;28;53
176;1;181015;5;15;17;22;54
177;1;180613;1;19;8;21;48
178;1;151410;6;6;8;12;26
179;1;180714;3;14;11;46;71
180;1;180813;4;15;5;32;52
181;1;180317;8;19;12;40;71
182;1;170917;3;17;18;13;48
183;1;180512;3;7;7;37;51
184;1;151312;7;19;5;50;74
185;1;170918;3;13;19;37;69
186;1;180216;9;5;18;44;67
187;1;151411;6;6;16;51;73
188;1;151511;8;11;17;37;65
189;1;180419;10;10;15;58;83
190;1;151512;8;11;18;41;70
191;1;180614;1;19;6;51;76
192;1;180715;3;20;8;36;64
193;1;180513;3;7;14;46;67
194;1;151313;7;13;7;28;48
195;1;180615;1;20;8;59;87
196;1;180716;3;18;6;23;47
197;1;180814;4;9;11;13;33
198;1;180318;8;13;14;51;78
199;1;180616;1;14;11;44;69
200;1;181016;5;13;9;6;28
201;1;180119;1;7;15;52;74
202;1;151412;6;10;5;30;45
203;1;180420;10;18;8;58;84
204;1;180319;8;16;7;6;29
205;1;180717;3;20;17;60;97
206;1;151413;6;16;10;45;71
207;1;180815;4;20;17;30;67
208;1;151513;8;15;9;23;47
209;1;181017;5;11;20;44;75
210;1;181018;5;20;5;24;49
211;1;151514;8;19;10;40;69
212;1;180120;1;20;15;53;88
213;1;180617;1;20;19;31;70
214;1;180718;3;18;6;16;40
215;1;180816;4;5;13;38;56
216;1;180514;3;16;17;9;42
217;1;180421;10;11;11;21;43
218;1;180618;1;15;10;19;44
219;1;151515;8;9;13;27;49
220;1;151314;7;15;12;32;59
221;1;180217;9;9;11;18;38
222;1;180320;8;6;8;13;27
223;1;180121;1;7;9;50;66
224;1;181019;5;11;10;6;27
225;1;151414;6;14;8;29;51
226;1;180122;1;17;14;14;45
227;1;180218;9;13;18;52;83
228;1;180515;3;14;16;17;47
229;1;180321;8;18;17;15;50
230;1;180219;9;13;9;14;36
231;1;180422;10;20;20;40;80
232;1;180719;3;13;18;51;82
233;1;180817;4;19;20;12;51
234;1;181020;5;5;16;18;39
235;1;180220;9;12;5;25;42
236;1;181021;5;18;6;13;37
237;1;151415;6;6;10;36;52
238;1;180322;8;13;7;17;37
239;1;180516;3;19;20;21;60
240;1;180619;1;9;11;47;67
241;1;180720;3;16;16;5;37
242;1;180818;4;20;11;31;62
243;1;181022;5;17;6;21;44
244;1;180819;4;11;8;54;73
245;1;151315;7;18;11;39;68
246;1;180517;3;8;8;45;61
247;1;151416;6;18;7;15;40
248;1;180518;3;10;6;5;21
249;1;151516;8;7;15;19;41
250;1;180423;10;8;14;21;43
251;1;151316;7;12;8;25;45
252;1;151417;6;8;8;38;54
253;1;180221;9;16;16;26;58
254;1;151517;8;12;16;47;75
255;1;180323;8;11;7;50;68
256;1;180820;4;17;8;50;75
257;1;180222;9;9;20;40;69
258;1;181023;5;19;5;28;52
259;1;181024;5;18;16;30;64
260;1;180821;4;16;5;53;74
261;1;151317;7;7;8;26;41
262;1;180519;3;11;18;58;87
263;1;180123;1;7;10;44;61
264;1;180620;1;13;7;7;27
265;1;180424;10;15;17;44;76
266;1;180223;9;10;18;55;83
267;1;180721;3;6;12;17;35
268;1;180324;8;10;7;34;51
269;1;180520;3;13;14;42;69
270;1;180822;4;16;13;17;46
271;1;181025;5;7;9;18;34
272;1;151418;6;6;19;49;74
273;1;180224;9;8;10;35;53
274;1;180722;3;13;17;11;41
275;1;180425;10;14;9;28;51
276;1;180521;3;15;9;51;75
277;1;180621;1;20;16;53;89
278;1;180124;1;16;8;9;33
279;1;180325;8;5;16;57;78
280;1;151419;6;9;8;26;43
281;1;180723;3;5;9;11;25
282;1;180823;4;10;17;28;55
283;1;180125;1;18;19;60;97
284;1;151518;8;12;8;60;80
285;1;180522;3;18;9;15;42
286;1;180622;1;8;13;25;46
287;1;180523;3;14;15;6;35
288;1;180225;9;9;20;16;45
289;1;180524;3;6;7;8;21
290;1;180126;1;10;6;53;69
291;1;180326;8;6;13;38;57
292;1;180724;3;5;9;26;40
293;1;151318;7;19;19;40;78
294;1;180127;1;6;19;51;76
295;1;180426;10;6;12;7;25
296;1;180824;4;19;17;53;89
297;1;180825;4;12;17;52;81
298;1;180525;3;7;18;26;51
299;1;180526;3;13;7;23;43
300;1;180623;1;10;19;31;60
301;1;180624;1;6;13;16;35
302;2;151301;5;8;18;36;62
303;2;180101;2;16;6;26;48
304;2;180501;5;11;13;20;44
305;2;180701;1;10;14;41;65
306;2;180201;7;6;10;39;55
307;2;180301;7;19;18;50;87
308;2;151501;11;18;17;42;77
309;2;170901;7;20;19;48;87
310;2;151302;5;8;20;36;64
311;2;180801;10;13;12;31;56
312;2;181001;8;19;6;36;61
313;2;180102;2;7;20;53;80
314;2;180401;4;6;12;41;59
315;2;180502;5;20;9;31;60
316;2;180202;7;18;11;11;40
317;2;180302;7;9;11;44;64
318;2;180601;3;14;18;59;91
319;2;180303;7;11;5;16;32
320;2;180402;4;15;20;52;87
321;2;180702;1;15;18;19;52
322;2;180103;2;14;13;18;45
323;2;170902;7;10;10;19;39
324;2;180203;7;7;6;9;22
325;2;180802;10;13;16;12;41
326;2;180503;5;5;18;25;48
327;2;180304;7;15;9;20;44
328;2;180403;4;13;11;22;46
329;2;180602;3;8;10;48;66
330;2;180703;1;12;7;39;58
331;2;151401;8;19;5;33;57
332;2;180104;2;14;14;53;81
333;2;170903;7;13;7;45;65
334;2;180105;2;16;5;47;68
335;2;180204;7;19;18;22;59
336;2;180305;7;18;12;19;49
337;2;170904;7;16;9;33;58
338;2;180404;4;15;14;53;82
339;2;180106;2;15;7;21;43
340;2;151303;5;5;18;30;53
341;2;181002;8;6;12;47;65
342;2;180704;1;15;11;37;63
343;2;151402;8;14;19;38;71
344;2;180504;5;18;10;59;87
345;2;151304;5;18;11;28;57
346;2;151502;11;8;10;7;25
347;2;180705;1;11;11;7;29
348;2;180603;3;20;12;48;80
349;2;180803;10;8;14;18;40
350;2;180306;7;12;5;37;54
351;2;151503;11;10;11;52;73
352;2;180205;7;11;20;47;78
353;2;170905;7;13;18;17;48
354;2;181003;8;19;8;16;43
355;2;180405;4;10;16;27;53
356;2;151305;5;19;17;48;84
357;2;180307;7;12;18;21;51
358;2;181004;8;5;12;9;26
359;2;180406;4;14;14;29;57
360;2;180505;5;20;16;21;57
361;2;170906;7;14;11;59;84
362;2;180604;3;10;12;47;69
363;2;180308;7;15;11;32;58
364;2;151403;8;10;18;27;55
365;2;180206;7;14;16;54;84
366;2;180407;4;15;8;8;31
367;2;180706;1;9;12;16;37
368;2;180107;2;20;10;12;42
369;2;180804;10;8;14;56;78
370;2;180207;7;19;20;44;83
371;2;151504;11;5;7;8;20
372;2;180408;4;17;14;7;38
373;2;170907;7;5;11;21;37
374;2;180108;2;17;9;7;33
375;2;180309;7;18;7;32;57
376;2;181005;8;12;12;14;38
377;2;180605;3;7;14;36;57
378;2;180109;2;16;16;43;75
379;2;151306;5;19;8;35;62
380;2;180707;1;11;18;23;52
381;2;180110;2;11;18;41;70
382;2;180409;4;9;10;50;69
383;2;170908;7;6;9;46;61
384;2;180506;5;12;12;45;69
385;2;180606;3;5;7;24;36
386;2;151404;8;10;20;7;37
387;2;180805;10;16;6;39;61
388;2;151505;11;8;15;38;61
389;2;180410;4;8;14;47;69
390;2;151307;5;9;9;39;57
391;2;180310;7;20;8;40;68
392;2;170909;7;10;14;24;48
393;2;181006;8;6;8;37;51
394;2;180111;2;16;14;42;72
395;2;170910;7;5;16;8;29
396;2;151506;11;5;15;52;72
397;2;180311;7;7;10;22;39
398;2;180112;2;18;19;56;93
399;2;180708;1;17;20;19;56
400;2;180507;5;7;12;24;43
401;2;180607;3;9;12;14;35
402;2;180709;1;18;5;39;62
403;2;180806;10;16;14;46;76
404;2;181007;8;11;5;37;53
405;2;180411;4;11;20;57;88
406;2;180208;7;14;20;18;52
407;2;180312;7;20;15;51;86
408;2;180412;4;15;11;53;79
409;2;180113;2;16;11;60;87
410;2;181008;8;6;15;21;42
411;2;180508;5;9;16;49;74
412;2;151308;5;11;16;10;37
413;2;151405;8;8;9;41;58
414;2;180608;3;16;9;38;63
415;2;151507;11;20;12;56;88
416;2;180209;7;5;16;30;51
417;2;180313;7;8;18;27;53
418;2;180413;4;16;8;39;63
419;2;180114;2;19;20;30;69
420;2;180210;7;6;19;60;85
421;2;180710;1;13;18;34;65
422;2;180807;10;18;12;36;66
423;2;180211;7;7;15;51;73
424;2;180115;2;7;13;54;74
425;2;180212;7;17;11;60;88
426;2;180414;4;13;9;53;75
427;2;180314;7;6;19;52;77
428;2;180213;7;17;14;41;72
429;2;181009;8;8;7;29;44
430;2;180509;5;14;12;26;52
431;2;180808;10;17;5;17;39
432;2;180415;4;6;14;29;49
433;2;180609;3;15;14;9;38
434;2;151406;8;5;5;46;56
435;2;151508;11;18;19;34;71
436;2;180116;2;6;18;17;41
437;2;180315;7;15;17;53;85
438;2;181010;8;17;11;40;68
439;2;180416;4;11;14;29;54
440;2;180117;2;16;19;36;71
441;2;170911;7;7;17;30;54
442;2;180610;3;17;15;10;42
443;2;170912;7;6;12;29;47
444;2;180711;1;19;13;48;80
445;2;170913;7;17;5;39;61
446;2;180809;10;18;14;30;62
447;2;181011;8;9;7;58;74
448;2;170914;7;10;20;51;81
449;2;180214;7;9;10;21;40
450;2;180316;7;13;5;32;50
451;2;170915;7;12;15;34;61
452;2;151309;5;10;10;37;57
453;2;151407;8;19;18;27;64
454;2;180510;5;12;19;43;74
455;2;151509;11;8;16;8;32
456;2;151310;5;7;13;38;58
457;2;180215;7;20;17;57;94
458;2;180611;3;6;20;47;73
459;2;180712;1;15;5;58;78
460;2;180810;10;11;11;13;35
461;2;181012;8;16;7;30;53
462;2;180417;4;15;6;32;53
463;2;151408;8;5;9;23;37
464;2;181013;8;6;6;44;56
465;2;151510;11;5;14;55;74
466;2;151311;5;5;12;13;30
467;2;180811;10;17;13;37;67
468;2;180511;5;10;16;21;47
469;2;151409;8;5;10;52;67
470;2;180612;3;11;18;10;39
471;2;170916;7;5;8;46;59
472;2;180713;1;12;14;24;50
473;2;180812;10;5;14;43;62
474;2;180118;2;7;10;7;24
475;2;181014;8;10;7;6;23
476;2;180418;4;14;8;11;33
477;2;181015;8;13;16;55;84
478;2;180613;3;9;14;10;33
479;2;151410;8;10;12;21;43
480;2;180714;1;5;5;15;25
481;2;180813;10;12;9;51;72
482;2;180317;7;19;15;26;60
483;2;170917;7;7;18;55;80
484;2;180512;5;19;16;38;73
485;2;151312;5;18;7;60;85
486;2;170918;7;15;13;57;85
487;2;180216;7;8;18;12;38
488;2;151411;8;13;12;16;41
489;2;151511;11;16;12;10;38
490;2;180419;4;8;16;6;30
491;2;151512;11;8;17;47;72
492;2;180614;3;16;12;19;47
493;2;180715;1;5;13;25;43
494;2;180513;5;11;5;35;51
495;2;151313;5;20;19;41;80
496;2;180615;3;20;14;34;68
497;2;180716;1;10;11;38;59
498;2;180814;10;8;16;59;83
499;2;180318;7;10;16;31;57
500;2;180616;3;17;17;15;49
501;2;181016;8;5;11;51;67
502;2;180119;2;7;10;33;50
503;2;151412;8;6;7;60;73
504;2;180420;4;20;14;14;48
505;2;180319;7;11;9;30;50
506;2;180717;1;14;19;24;57
507;2;151413;8;10;17;27;54
508;2;180815;10;7;13;49;69
509;2;151513;11;11;5;27;43
510;2;181017;8;12;7;22;41
511;2;181018;8;13;9;43;65
512;2;151514;11;12;20;37;69
513;2;180120;2;7;13;52;72
514;2;180617;3;15;10;32;57
515;2;180718;1;10;12;46;68
516;2;180816;10;5;11;40;56
517;2;180514;5;10;19;17;46
518;2;180421;4;8;12;57;77
519;2;180618;3;15;17;32;64
520;2;151515;11;12;13;11;36
521;2;151314;5;19;16;35;70
522;2;180217;7;16;16;11;43
523;2;180320;7;5;6;54;65
524;2;180121;2;13;16;43;72
525;2;181019;8;15;6;12;33
526;2;151414;8;11;20;58;89
527;2;180122;2;11;6;37;54
528;2;180218;7;12;10;12;34
529;2;180515;5;16;11;50;77
530;2;180321;7;18;13;24;55
531;2;180219;7;11;6;49;66
532;2;180422;4;19;14;24;57
533;2;180719;1;19;6;44;69
534;2;180817;10;14;14;36;64
535;2;181020;8;20;5;49;74
536;2;180220;7;15;11;30;56
537;2;181021;8;19;18;27;64
538;2;151415;8;20;11;16;47
539;2;180322;7;8;11;27;46
540;2;180516;5;18;13;14;45
541;2;180619;3;11;16;33;60
542;2;180720;1;18;6;50;74
543;2;180818;10;13;10;25;48
544;2;181022;8;19;5;53;77
545;2;180819;10;6;14;16;36
546;2;151315;5;16;12;27;55
547;2;180517;5;7;19;46;72
548;2;151416;8;14;16;34;64
549;2;180518;5;6;10;17;33
550;2;151516;11;6;18;40;64
551;2;180423;4;17;16;19;52
552;2;151316;5;16;14;59;89
553;2;151417;8;6;8;21;35
554;2;180221;7;18;9;54;81
555;2;151517;11;8;15;52;75
556;2;180323;7;19;19;21;59
557;2;180820;10;20;18;25;63
558;2;180222;7;16;9;9;34
559;2;181023;8;5;18;8;31
560;2;181024;8;8;8;56;72
561;2;180821;10;5;8;35;48
562;2;151317;5;8;16;48;72
563;2;180519;5;16;6;15;37
564;2;180123;2;6;19;39;64
565;2;180620;3;14;13;13;40
566;2;180424;4;10;20;58;88
567;2;180223;7;8;6;57;71
568;2;180721;1;7;14;57;78
569;2;180324;7;20;17;49;86
570;2;180520;5;16;7;53;76
571;2;180822;10;17;11;12;40
572;2;181025;8;20;13;38;71
573;2;151418;8;5;16;8;29
574;2;180224;7;6;11;17;34
575;2;180722;1;11;17;51;79
576;2;180425;4;5;9;25;39
577;2;180521;5;7;18;54;79
578;2;180621;3;6;13;18;37
579;2;180124;2;16;5;34;55
580;2;180325;7;8;14;44;66
581;2;151419;8;20;6;20;46
582;2;180723;1;17;7;12;36
583;2;180823;10;16;17;10;43
584;2;180125;2;12;19;30;61
585;2;151518;11;20;10;15;45
586;2;180522;5;9;17;33;59
587;2;180622;3;16;14;27;57
588;2;180523;5;9;5;5;19
589;2;180225;7;16;11;46;73
590;2;180524;5;11;17;50;78
591;2;180126;2;8;13;51;72
592;2;180326;7;15;12;5;32
593;2;180724;1;13;13;50;76
594;2;151318;5;9;7;27;43
595;2;180127;2;16;19;16;51
596;2;180426;4;13;17;23;53
597;2;180824;10;10;14;46;70
598;2;180825;10;14;9;37;60
599;2;180525;5;8;8;60;76
600;2;180526;5;8;13;58;79
601;2;180623;3;12;5;57;74
602;2;180624;3;9;5;48;62
603;3;151301;6;10;10;38;58
604;3;180101;4;15;19;56;90
605;3;180501;4;7;6;47;60
606;3;180701;3;20;9;50;79
607;3;180201;5;16;12;32;60
608;3;180301;11;18;18;32;68
609;3;151501;6;20;20;52;92
610;3;170901;9;14;17;39;70
611;3;151302;6;20;7;45;72
612;3;180801;8;10;5;60;75
613;3;181001;1;20;12;47;79
614;3;180102;4;18;19;38;75
615;3;180401;3;7;13;20;40
616;3;180502;4;14;16;49;79
617;3;180202;5;19;17;8;44
618;3;180302;11;18;20;11;49
619;3;180601;5;6;5;45;56
620;3;180303;11;17;6;17;40
621;3;180402;3;17;9;31;57
622;3;180702;3;17;16;11;44
623;3;180103;4;8;17;17;42
624;3;170902;9;18;16;54;88
625;3;180203;5;10;7;43;60
626;3;180802;8;14;18;28;60
627;3;180503;4;14;14;41;69
628;3;180304;11;7;10;30;47
629;3;180403;3;11;8;46;65
630;3;180602;5;8;15;25;48
631;3;180703;3;11;16;5;32
632;3;151401;2;18;14;26;58
633;3;180104;4;15;9;49;73
634;3;170903;9;20;19;6;45
635;3;180105;4;7;7;42;56
636;3;180204;5;7;10;21;38
637;3;180305;11;14;9;22;45
638;3;170904;9;10;10;43;63
639;3;180404;3;16;6;35;57
640;3;180106;4;17;19;54;90
641;3;151303;6;13;5;35;53
642;3;181002;1;13;5;24;42
643;3;180704;3;9;20;56;85
644;3;151402;2;17;13;59;89
645;3;180504;4;17;11;12;40
646;3;151304;6;14;6;30;50
647;3;151502;6;6;6;59;71
648;3;180705;3;6;13;54;73
649;3;180603;5;9;6;47;62
650;3;180803;8;6;18;14;38
651;3;180306;11;14;19;34;67
652;3;151503;6;20;20;31;71
653;3;180205;5;5;7;50;62
654;3;170905;9;16;13;9;38
655;3;181003;1;12;19;55;86
656;3;180405;3;11;10;18;39
657;3;151305;6;10;15;22;47
658;3;180307;11;12;18;19;49
659;3;181004;1;18;9;20;47
660;3;180406;3;17;17;32;66
661;3;180505;4;20;20;54;94
662;3;170906;9;7;7;21;35
663;3;180604;5;20;20;41;81
664;3;180308;11;17;5;38;60
665;3;151403;2;9;9;52;70
666;3;180206;5;7;10;46;63
667;3;180407;3;11;8;56;75
668;3;180706;3;9;16;32;57
669;3;180107;4;12;14;45;71
670;3;180804;8;16;6;22;44
671;3;180207;5;17;11;12;40
672;3;151504;6;20;7;15;42
673;3;180408;3;16;20;46;82
674;3;170907;9;18;18;10;46
675;3;180108;4;9;14;45;68
676;3;180309;11;9;20;28;57
677;3;181005;1;6;6;25;37
678;3;180605;5;20;8;54;82
679;3;180109;4;11;18;57;86
680;3;151306;6;5;8;53;66
681;3;180707;3;7;8;46;61
682;3;180110;4;5;15;51;71
683;3;180409;3;16;10;16;42
684;3;170908;9;16;17;39;72
685;3;180506;4;18;13;38;69
686;3;180606;5;18;10;11;39
687;3;151404;2;13;11;15;39
688;3;180805;8;12;17;5;34
689;3;151505;6;16;7;12;35
690;3;180410;3;17;15;28;60
691;3;151307;6;14;10;53;77
692;3;180310;11;13;13;30;56
693;3;170909;9;14;9;18;41
694;3;181006;1;18;16;51;85
695;3;180111;4;19;13;15;47
696;3;170910;9;20;13;30;63
697;3;151506;6;17;13;26;56
698;3;180311;11;13;6;56;75
699;3;180112;4;18;14;12;44
700;3;180708;3;15;19;39;73
701;3;180507;4;10;7;10;27
702;3;180607;5;7;16;48;71
703;3;180709;3;13;19;27;59
704;3;180806;8;13;9;7;29
705;3;181007;1;15;19;12;46
706;3;180411;3;12;13;42;67
707;3;180208;5;6;18;38;62
708;3;180312;11;13;19;33;65
709;3;180412;3;6;16;53;75
710;3;180113;4;8;14;56;78
711;3;181008;1;14;17;44;75
712;3;180508;4;6;15;5;26
713;3;151308;6;18;16;11;45
714;3;151405;2;13;20;36;69
715;3;180608;5;12;9;41;62
716;3;151507;6;6;9;20;35
717;3;180209;5;9;14;31;54
718;3;180313;11;5;15;40;60
719;3;180413;3;5;20;50;75
720;3;180114;4;14;9;33;56
721;3;180210;5;15;18;30;63
722;3;180710;3;17;18;56;91
723;3;180807;8;18;15;27;60
724;3;180211;5;8;19;8;35
725;3;180115;4;9;12;56;77
726;3;180212;5;19;15;32;66
727;3;180414;3;19;15;13;47
728;3;180314;11;16;15;30;61
729;3;180213;5;12;17;48;77
730;3;181009;1;5;12;15;32
731;3;180509;4;9;17;35;61
732;3;180808;8;19;8;46;73
733;3;180415;3;16;8;5;29
734;3;180609;5;5;14;18;37
735;3;151406;2;20;11;24;55
736;3;151508;6;8;6;54;68
737;3;180116;4;18;20;28;66
738;3;180315;11;17;6;27;50
739;3;181010;1;10;8;48;66
740;3;180416;3;5;15;43;63
741;3;180117;4;11;10;40;61
742;3;170911;9;5;9;45;59
743;3;180610;5;7;11;42;60
744;3;170912;9;17;8;29;54
745;3;180711;3;8;18;46;72
746;3;170913;9;14;14;49;77
747;3;180809;8;11;5;52;68
748;3;181011;1;9;9;39;57
749;3;170914;9;17;10;31;58
750;3;180214;5;11;19;31;61
751;3;180316;11;8;17;55;80
752;3;170915;9;5;8;44;57
753;3;151309;6;19;7;47;73
754;3;151407;2;9;5;15;29
755;3;180510;4;19;11;45;75
756;3;151509;6;14;15;55;84
757;3;151310;6;9;5;28;42
758;3;180215;5;17;14;38;69
759;3;180611;5;8;6;48;62
760;3;180712;3;6;18;21;45
761;3;180810;8;13;7;11;31
762;3;181012;1;16;10;16;42
763;3;180417;3;19;13;35;67
764;3;151408;2;6;20;30;56
765;3;181013;1;8;18;59;85
766;3;151510;6;17;9;58;84
767;3;151311;6;8;13;24;45
768;3;180811;8;15;5;18;38
769;3;180511;4;13;10;6;29
770;3;151409;2;17;15;11;43
771;3;180612;5;16;10;56;82
772;3;170916;9;7;16;37;60
773;3;180713;3;13;19;15;47
774;3;180812;8;10;7;37;54
775;3;180118;4;18;20;50;88
776;3;181014;1;6;6;32;44
777;3;180418;3;20;14;53;87
778;3;181015;1;16;17;13;46
779;3;180613;5;12;20;29;61
780;3;151410;2;18;13;54;85
781;3;180714;3;5;6;58;69
782;3;180813;8;11;19;5;35
783;3;180317;11;16;7;9;32
784;3;170917;9;12;18;32;62
785;3;180512;4;13;20;55;88
786;3;151312;6;17;13;55;85
787;3;170918;9;9;9;34;52
788;3;180216;5;5;8;55;68
789;3;151411;2;11;7;45;63
790;3;151511;6;11;15;23;49
791;3;180419;3;12;13;12;37
792;3;151512;6;20;15;39;74
793;3;180614;5;19;6;9;34
794;3;180715;3;9;13;36;58
795;3;180513;4;7;18;34;59
796;3;151313;6;18;17;41;76
797;3;180615;5;13;9;44;66
798;3;180716;3;17;11;51;79
799;3;180814;8;12;14;8;34
800;3;180318;11;13;19;46;78
801;3;180616;5;14;15;15;44
802;3;181016;1;13;13;51;77
803;3;180119;4;16;16;14;46
804;3;151412;2;8;20;58;86
805;3;180420;3;9;12;26;47
806;3;180319;11;14;10;5;29
807;3;180717;3;13;6;36;55
808;3;151413;2;14;16;8;38
809;3;180815;8;6;8;27;41
810;3;151513;6;18;17;23;58
811;3;181017;1;16;12;34;62
812;3;181018;1;17;20;58;95
813;3;151514;6;7;12;28;47
814;3;180120;4;10;14;12;36
815;3;180617;5;14;17;13;44
816;3;180718;3;12;20;53;85
817;3;180816;8;10;7;33;50
818;3;180514;4;14;14;28;56
819;3;180421;3;8;14;52;74
820;3;180618;5;11;10;39;60
821;3;151515;6;9;12;38;59
822;3;151314;6;18;9;42;69
823;3;180217;5;7;8;57;72
824;3;180320;11;17;5;23;45
825;3;180121;4;11;5;46;62
826;3;181019;1;16;12;7;35
827;3;151414;2;5;18;50;73
828;3;180122;4;18;11;7;36
829;3;180218;5;14;6;6;26
830;3;180515;4;8;13;9;30
831;3;180321;11;8;18;29;55
832;3;180219;5;7;13;12;32
833;3;180422;3;11;15;53;79
834;3;180719;3;5;16;52;73
835;3;180817;8;17;8;29;54
836;3;181020;1;12;9;55;76
837;3;180220;5;14;8;28;50
838;3;181021;1;8;5;36;49
839;3;151415;2;20;5;27;52
840;3;180322;11;18;8;32;58
841;3;180516;4;17;7;9;33
842;3;180619;5;11;18;51;80
843;3;180720;3;17;7;50;74
844;3;180818;8;9;5;31;45
845;3;181022;1;16;18;34;68
846;3;180819;8;13;13;41;67
847;3;151315;6;10;9;41;60
848;3;180517;4;7;5;42;54
849;3;151416;2;11;9;55;75
850;3;180518;4;13;17;26;56
851;3;151516;6;16;15;21;52
852;3;180423;3;6;19;15;40
853;3;151316;6;20;8;31;59
854;3;151417;2;11;19;50;80
855;3;180221;5;9;16;52;77
856;3;151517;6;20;9;20;49
857;3;180323;11;18;11;53;82
858;3;180820;8;18;12;17;47
859;3;180222;5;12;9;58;79
860;3;181023;1;18;20;49;87
861;3;181024;1;6;14;56;76
862;3;180821;8;13;19;47;79
863;3;151317;6;8;12;12;32
864;3;180519;4;16;11;10;37
865;3;180123;4;10;9;23;42
866;3;180620;5;19;6;30;55
867;3;180424;3;17;7;19;43
868;3;180223;5;16;8;17;41
869;3;180721;3;20;17;35;72
870;3;180324;11;20;7;52;79
871;3;180520;4;16;9;25;50
872;3;180822;8;10;12;18;40
873;3;181025;1;9;17;37;63
874;3;151418;2;17;17;23;57
875;3;180224;5;11;13;28;52
876;3;180722;3;6;16;14;36
877;3;180425;3;6;16;11;33
878;3;180521;4;13;19;57;89
879;3;180621;5;11;20;47;78
880;3;180124;4;14;6;20;40
881;3;180325;11;6;11;29;46
882;3;151419;2;5;16;59;80
883;3;180723;3;19;18;18;55
884;3;180823;8;12;16;55;83
885;3;180125;4;15;5;49;69
886;3;151518;6;7;8;54;69
887;3;180522;4;18;6;59;83
888;3;180622;5;5;6;53;64
889;3;180523;4;11;9;29;49
890;3;180225;5;9;6;53;68
891;3;180524;4;7;7;36;50
892;3;180126;4;14;7;57;78
893;3;180326;11;5;16;34;55
894;3;180724;3;17;10;49;76
895;3;151318;6;5;9;52;66
896;3;180127;4;16;15;54;85
897;3;180426;3;8;13;11;32
898;3;180824;8;6;8;49;63
899;3;180825;8;10;7;33;50
900;3;180525;4;19;14;16;49
901;3;180526;4;12;16;17;45
902;3;180623;5;20;7;22;49
903;3;180624;5;18;8;44;70
904;4;151301;6;10;13;34;57
905;4;180101;10;17;8;44;69
906;4;180501;4;5;6;51;62
907;4;180701;1;11;12;34;57
908;4;180201;9;18;19;31;68
909;4;180301;7;16;20;52;88
910;4;151501;5;6;5;27;38
911;4;170901;8;15;10;42;67
912;4;151302;6;12;10;22;44
913;4;180801;7;9;5;8;22
914;4;181001;9;14;5;51;70
915;4;180102;10;6;7;30;43
916;4;180401;3;12;13;42;67
917;4;180502;4;7;5;56;68
918;4;180202;9;20;5;36;61
919;4;180302;7;18;14;28;60
920;4;180601;6;13;17;47;77
921;4;180303;7;16;17;7;40
922;4;180402;3;19;7;19;45
923;4;180702;1;14;17;45;76
924;4;180103;10;14;11;27;52
925;4;170902;8;19;17;36;72
926;4;180203;9;17;10;12;39
927;4;180802;7;16;11;17;44
928;4;180503;4;14;17;14;45
929;4;180304;7;15;12;9;36
930;4;180403;3;18;10;5;33
931;4;180602;6;10;19;30;59
932;4;180703;1;8;18;11;37
933;4;151401;4;11;19;45;75
934;4;180104;10;20;13;47;80
935;4;170903;8;14;19;17;50
936;4;180105;10;10;14;28;52
937;4;180204;9;12;7;5;24
938;4;180305;7;14;6;9;29
939;4;170904;8;16;8;23;47
940;4;180404;3;12;13;13;38
941;4;180106;10;18;10;47;75
942;4;151303;6;13;15;26;54
943;4;181002;9;14;20;10;44
944;4;180704;1;8;18;24;50
945;4;151402;4;14;15;27;56
946;4;180504;4;16;13;56;85
947;4;151304;6;14;14;23;51
948;4;151502;5;13;5;28;46
949;4;180705;1;19;7;32;58
950;4;180603;6;19;15;8;42
951;4;180803;7;5;9;41;55
952;4;180306;7;10;9;34;53
953;4;151503;5;19;8;47;74
954;4;180205;9;11;14;18;43
955;4;170905;8;5;17;14;36
956;4;181003;9;15;5;29;49
957;4;180405;3;20;11;29;60
958;4;151305;6;16;5;39;60
959;4;180307;7;17;7;12;36
960;4;181004;9;10;17;60;87
961;4;180406;3;20;16;26;62
962;4;180505;4;11;11;34;56
963;4;170906;8;5;18;25;48
964;4;180604;6;5;10;55;70
965;4;180308;7;12;20;12;44
966;4;151403;4;6;10;12;28
967;4;180206;9;20;6;35;61
968;4;180407;3;13;7;49;69
969;4;180706;1;9;12;9;30
970;4;180107;10;20;17;26;63
971;4;180804;7;17;13;52;82
972;4;180207;9;8;13;20;41
973;4;151504;5;18;14;36;68
974;4;180408;3;19;17;45;81
975;4;170907;8;8;17;16;41
976;4;180108;10;6;11;17;34
977;4;180309;7;17;13;54;84
978;4;181005;9;18;14;46;78
979;4;180605;6;20;14;9;43
980;4;180109;10;5;7;11;23
981;4;151306;6;5;13;56;74
982;4;180707;1;5;16;60;81
983;4;180110;10;14;15;29;58
984;4;180409;3;14;9;50;73
985;4;170908;8;15;10;42;67
986;4;180506;4;19;7;41;67
987;4;180606;6;20;6;16;42
988;4;151404;4;13;11;34;58
989;4;180805;7;19;7;10;36
990;4;151505;5;8;5;27;40
991;4;180410;3;11;17;46;74
992;4;151307;6;17;5;24;46
993;4;180310;7;16;6;45;67
994;4;170909;8;12;11;39;62
995;4;181006;9;20;8;18;46
996;4;180111;10;18;9;56;83
997;4;170910;8;6;18;16;40
998;4;151506;5;18;16;30;64
999;4;180311;7;16;12;22;50
1000;4;180112;10;10;15;55;80
1001;4;180708;1;11;11;48;70
1002;4;180507;4;20;13;38;71
1003;4;180607;6;7;15;29;51
1004;4;180709;1;14;16;15;45
1005;4;180806;7;9;11;8;28
1006;4;181007;9;11;12;20;43
1007;4;180411;3;7;20;5;32
1008;4;180208;9;9;5;40;54
1009;4;180312;7;8;15;26;49
1010;4;180412;3;19;13;25;57
1011;4;180113;10;18;16;27;61
1012;4;181008;9;9;6;58;73
1013;4;180508;4;5;9;19;33
1014;4;151308;6;12;8;17;37
1015;4;151405;4;5;12;57;74
1016;4;180608;6;11;15;5;31
1017;4;151507;5;8;6;27;41
1018;4;180209;9;8;8;24;40
1019;4;180313;7;7;6;36;49
1020;4;180413;3;16;16;7;39
1021;4;180114;10;10;16;56;82
1022;4;180210;9;17;16;47;80
1023;4;180710;1;6;9;50;65
1024;4;180807;7;17;10;11;38
1025;4;180211;9;5;16;40;61
1026;4;180115;10;19;10;16;45
1027;4;180212;9;6;12;52;70
1028;4;180414;3;15;16;34;65
1029;4;180314;7;9;20;33;62
1030;4;180213;9;11;11;20;42
1031;4;181009;9;17;10;30;57
1032;4;180509;4;18;17;10;45
1033;4;180808;7;7;12;52;71
1034;4;180415;3;10;11;18;39
1035;4;180609;6;9;15;40;64
1036;4;151406;4;17;10;49;76
1037;4;151508;5;11;13;9;33
1038;4;180116;10;15;18;15;48
1039;4;180315;7;12;17;40;69
1040;4;181010;9;10;14;55;79
1041;4;180416;3;6;5;13;24
1042;4;180117;10;6;5;13;24
1043;4;170911;8;10;10;52;72
1044;4;180610;6;19;13;17;49
1045;4;170912;8;19;9;48;76
1046;4;180711;1;9;20;42;71
1047;4;170913;8;18;11;24;53
1048;4;180809;7;19;7;41;67
1049;4;181011;9;5;7;17;29
1050;4;170914;8;13;10;40;63
1051;4;180214;9;10;5;43;58
1052;4;180316;7;7;17;6;30
1053;4;170915;8;7;8;57;72
1054;4;151309;6;17;19;43;79
1055;4;151407;4;19;12;17;48
1056;4;180510;4;18;15;35;68
1057;4;151509;5;7;17;14;38
1058;4;151310;6;18;17;12;47
1059;4;180215;9;16;7;15;38
1060;4;180611;6;19;7;13;39
1061;4;180712;1;20;12;53;85
1062;4;180810;7;9;10;39;58
1063;4;181012;9;12;14;58;84
1064;4;180417;3;6;20;44;70
1065;4;151408;4;10;8;26;44
1066;4;181013;9;19;14;13;46
1067;4;151510;5;16;5;54;75
1068;4;151311;6;9;17;45;71
1069;4;180811;7;19;6;25;50
1070;4;180511;4;12;16;14;42
1071;4;151409;4;5;8;10;23
1072;4;180612;6;10;6;48;64
1073;4;170916;8;18;11;41;70
1074;4;180713;1;13;9;43;65
1075;4;180812;7;14;20;48;82
1076;4;180118;10;14;17;60;91
1077;4;181014;9;17;19;37;73
1078;4;180418;3;14;12;32;58
1079;4;181015;9;10;17;43;70
1080;4;180613;6;7;20;40;67
1081;4;151410;4;16;5;21;42
1082;4;180714;1;7;9;46;62
1083;4;180813;7;13;6;47;66
1084;4;180317;7;18;9;42;69
1085;4;170917;8;17;20;21;58
1086;4;180512;4;16;11;54;81
1087;4;151312;6;16;10;43;69
1088;4;170918;8;7;17;39;63
1089;4;180216;9;8;9;14;31
1090;4;151411;4;7;19;26;52
1091;4;151511;5;13;19;21;53
1092;4;180419;3;19;14;41;74
1093;4;151512;5;8;9;27;44
1094;4;180614;6;20;8;5;33
1095;4;180715;1;11;14;39;64
1096;4;180513;4;9;7;15;31
1097;4;151313;6;6;11;59;76
1098;4;180615;6;11;19;17;47
1099;4;180716;1;15;15;27;57
1100;4;180814;7;13;8;39;60
1101;4;180318;7;7;20;36;63
1102;4;180616;6;12;18;56;86
1103;4;181016;9;9;19;32;60
1104;4;180119;10;6;18;56;80
1105;4;151412;4;20;6;51;77
1106;4;180420;3;18;7;23;48
1107;4;180319;7;18;12;60;90
1108;4;180717;1;10;18;31;59
1109;4;151413;4;14;6;35;55
1110;4;180815;7;18;6;53;77
1111;4;151513;5;5;18;42;65
1112;4;181017;9;7;19;45;71
1113;4;181018;9;7;13;25;45
1114;4;151514;5;7;9;48;64
1115;4;180120;10;7;11;13;31
1116;4;180617;6;13;16;32;61
1117;4;180718;1;19;7;45;71
1118;4;180816;7;8;5;5;18
1119;4;180514;4;7;16;7;30
1120;4;180421;3;17;5;13;35
1121;4;180618;6;20;5;23;48
1122;4;151515;5;19;5;22;46
1123;4;151314;6;13;7;59;79
1124;4;180217;9;11;7;9;27
1125;4;180320;7;8;8;52;68
1126;4;180121;10;17;15;43;75
1127;4;181019;9;18;18;15;51
1128;4;151414;4;14;20;35;69
1129;4;180122;10;8;13;40;61
1130;4;180218;9;12;18;43;73
1131;4;180515;4;12;6;37;55
1132;4;180321;7;14;10;47;71
1133;4;180219;9;5;5;44;54
1134;4;180422;3;12;16;50;78
1135;4;180719;1;18;18;52;88
1136;4;180817;7;11;5;29;45
1137;4;181020;9;9;16;17;42
1138;4;180220;9;16;15;43;74
1139;4;181021;9;17;7;11;35
1140;4;151415;4;19;15;10;44
1141;4;180322;7;5;10;51;66
1142;4;180516;4;12;16;13;41
1143;4;180619;6;19;5;50;74
1144;4;180720;1;17;16;30;63
1145;4;180818;7;14;5;48;67
1146;4;181022;9;5;11;51;67
1147;4;180819;7;5;14;34;53
1148;4;151315;6;7;16;52;75
1149;4;180517;4;10;11;17;38
1150;4;151416;4;10;8;33;51
1151;4;180518;4;8;13;11;32
1152;4;151516;5;14;18;31;63
1153;4;180423;3;17;17;7;41
1154;4;151316;6;5;5;60;70
1155;4;151417;4;11;17;44;72
1156;4;180221;9;16;13;35;64
1157;4;151517;5;5;20;19;44
1158;4;180323;7;12;17;26;55
1159;4;180820;7;10;9;33;52
1160;4;180222;9;7;17;14;38
1161;4;181023;9;6;14;60;80
1162;4;181024;9;6;16;53;75
1163;4;180821;7;20;20;36;76
1164;4;151317;6;6;12;5;23
1165;4;180519;4;18;11;30;59
1166;4;180123;10;12;12;6;30
1167;4;180620;6;18;9;5;32
1168;4;180424;3;20;12;32;64
1169;4;180223;9;5;10;13;28
1170;4;180721;1;20;11;43;74
1171;4;180324;7;14;15;21;50
1172;4;180520;4;14;18;20;52
1173;4;180822;7;14;10;32;56
1174;4;181025;9;13;8;55;76
1175;4;151418;4;20;11;15;46
1176;4;180224;9;13;5;44;62
1177;4;180722;1;10;10;58;78
1178;4;180425;3;15;9;28;52
1179;4;180521;4;8;17;39;64
1180;4;180621;6;6;19;48;73
1181;4;180124;10;14;18;21;53
1182;4;180325;7;12;9;22;43
1183;4;151419;4;15;12;28;55
1184;4;180723;1;18;10;38;66
1185;4;180823;7;8;5;15;28
1186;4;180125;10;15;16;30;61
1187;4;151518;5;7;17;9;33
1188;4;180522;4;5;5;58;68
1189;4;180622;6;14;8;36;58
1190;4;180523;4;19;10;43;72
1191;4;180225;9;10;13;49;72
1192;4;180524;4;5;5;10;20
1193;4;180126;10;9;8;52;69
1194;4;180326;7;18;6;18;42
1195;4;180724;1;20;17;60;97
1196;4;151318;6;14;14;22;50
1197;4;180127;10;11;9;6;26
1198;4;180426;3;5;20;43;68
1199;4;180824;7;18;20;38;76
1200;4;180825;7;5;16;26;47
1201;4;180525;4;8;15;8;31
1202;4;180526;4;11;12;10;33
1203;4;180623;6;19;15;48;82
1204;4;180624;6;5;15;34;54
1205;5;151301;7;7;15;5;27
1206;5;180101;9;9;11;13;33
1207;5;180501;4;8;7;38;53
1208;5;180701;11;5;14;43;62
1209;5;180201;8;14;14;38;66
1210;5;180301;5;5;19;53;77
1211;5;151501;8;9;5;47;61
1212;5;170901;11;15;6;43;64
1213;5;151302;7;7;15;34;56
1214;5;180801;5;15;13;53;81
1215;5;181001;5;9;11;56;76
1216;5;180102;9;20;14;30;64
1217;5;180401;4;6;13;19;38
1218;5;180502;4;18;13;50;81
1219;5;180202;8;13;19;35;67
1220;5;180302;5;14;17;48;79
1221;5;180601;1;10;18;48;76
1222;5;180303;5;15;18;55;88
1223;5;180402;4;20;13;27;60
1224;5;180702;11;10;19;8;37
1225;5;180103;9;10;15;13;38
1226;5;170902;11;6;10;6;22
1227;5;180203;8;13;17;53;83
1228;5;180802;5;12;5;11;28
1229;5;180503;4;10;11;18;39
1230;5;180304;5;16;5;53;74
1231;5;180403;4;12;14;48;74
1232;5;180602;1;18;19;49;86
1233;5;180703;11;11;13;8;32
1234;5;151401;1;19;8;47;74
1235;5;180104;9;17;5;43;65
1236;5;170903;11;12;19;12;43
1237;5;180105;9;8;8;36;52
1238;5;180204;8;15;11;44;70
1239;5;180305;5;10;11;15;36
1240;5;170904;11;15;12;48;75
1241;5;180404;4;5;9;53;67
1242;5;180106;9;5;19;54;78
1243;5;151303;7;8;16;11;35
1244;5;181002;5;18;18;52;88
1245;5;180704;11;16;12;56;84
1246;5;151402;1;19;11;8;38
1247;5;180504;4;8;17;49;74
1248;5;151304;7;7;20;8;35
1249;5;151502;8;5;20;24;49
1250;5;180705;11;5;17;34;56
1251;5;180603;1;6;19;22;47
1252;5;180803;5;5;13;60;78
1253;5;180306;5;10;20;16;46
1254;5;151503;8;12;8;10;30
1255;5;180205;8;15;13;47;75
1256;5;170905;11;13;7;44;64
1257;5;181003;5;18;8;54;80
1258;5;180405;4;8;18;56;82
1259;5;151305;7;14;7;36;57
1260;5;180307;5;7;12;8;27
1261;5;181004;5;14;18;34;66
1262;5;180406;4;13;17;6;36
1263;5;180505;4;12;17;31;60
1264;5;170906;11;9;15;7;31
1265;5;180604;1;7;13;53;73
1266;5;180308;5;18;17;58;93
1267;5;151403;1;5;11;33;49
1268;5;180206;8;8;13;43;64
1269;5;180407;4;15;9;36;60
1270;5;180706;11;10;20;27;57
1271;5;180107;9;17;6;15;38
1272;5;180804;5;9;11;26;46
1273;5;180207;8;6;5;31;42
1274;5;151504;8;16;15;36;67
1275;5;180408;4;17;8;48;73
1276;5;170907;11;19;12;24;55
1277;5;180108;9;6;7;23;36
1278;5;180309;5;12;17;48;77
1279;5;181005;5;13;19;57;89
1280;5;180605;1;7;11;28;46
1281;5;180109;9;14;15;53;82
1282;5;151306;7;11;18;56;85
1283;5;180707;11;13;20;33;66
1284;5;180110;9;20;10;47;77
1285;5;180409;4;13;6;20;39
1286;5;170908;11;18;9;47;74
1287;5;180506;4;5;6;41;52
1288;5;180606;1;9;14;10;33
1289;5;151404;1;7;13;9;29
1290;5;180805;5;11;8;48;67
1291;5;151505;8;17;6;28;51
1292;5;180410;4;16;11;37;64
1293;5;151307;7;10;16;14;40
1294;5;180310;5;11;16;53;80
1295;5;170909;11;7;15;34;56
1296;5;181006;5;5;13;58;76
1297;5;180111;9;8;7;41;56
1298;5;170910;11;7;12;56;75
1299;5;151506;8;18;16;58;92
1300;5;180311;5;7;19;34;60
1301;5;180112;9;7;19;18;44
1302;5;180708;11;5;8;50;63
1303;5;180507;4;10;13;60;83
1304;5;180607;1;8;9;58;75
1305;5;180709;11;10;12;10;32
1306;5;180806;5;5;8;59;72
1307;5;181007;5;11;6;54;71
1308;5;180411;4;8;16;32;56
1309;5;180208;8;11;14;55;80
1310;5;180312;5;20;20;45;85
1311;5;180412;4;18;15;35;68
1312;5;180113;9;15;11;13;39
1313;5;181008;5;15;18;49;82
1314;5;180508;4;14;10;34;58
1315;5;151308;7;13;16;29;58
1316;5;151405;1;16;13;30;59
1317;5;180608;1;10;17;45;72
1318;5;151507;8;9;13;46;68
1319;5;180209;8;7;8;20;35
1320;5;180313;5;17;13;46;76
1321;5;180413;4;7;19;29;55
1322;5;180114;9;7;9;50;66
1323;5;180210;8;12;19;51;82
1324;5;180710;11;12;13;21;46
1325;5;180807;5;16;7;50;73
1326;5;180211;8;8;10;29;47
1327;5;180115;9;5;5;49;59
1328;5;180212;8;19;20;46;85
1329;5;180414;4;19;17;35;71
1330;5;180314;5;7;18;33;58
1331;5;180213;8;13;8;55;76
1332;5;181009;5;12;10;41;63
1333;5;180509;4;19;12;31;62
1334;5;180808;5;10;14;37;61
1335;5;180415;4;6;19;8;33
1336;5;180609;1;12;7;13;32
1337;5;151406;1;15;19;9;43
1338;5;151508;8;9;19;6;34
1339;5;180116;9;5;13;13;31
1340;5;180315;5;7;14;40;61
1341;5;181010;5;20;19;35;74
1342;5;180416;4;8;5;17;30
1343;5;180117;9;16;18;37;71
1344;5;170911;11;10;12;54;76
1345;5;180610;1;7;16;16;39
1346;5;170912;11;17;16;5;38
1347;5;180711;11;19;17;53;89
1348;5;170913;11;10;16;35;61
1349;5;180809;5;12;10;46;68
1350;5;181011;5;6;6;51;63
1351;5;170914;11;12;20;43;75
1352;5;180214;8;20;13;16;49
1353;5;180316;5;8;12;8;28
1354;5;170915;11;6;17;45;68
1355;5;151309;7;14;19;20;53
1356;5;151407;1;20;18;19;57
1357;5;180510;4;10;6;46;62
1358;5;151509;8;19;17;6;42
1359;5;151310;7;9;5;22;36
1360;5;180215;8;14;13;9;36
1361;5;180611;1;9;14;45;68
1362;5;180712;11;8;10;38;56
1363;5;180810;5;16;10;40;66
1364;5;181012;5;20;19;30;69
1365;5;180417;4;15;15;13;43
1366;5;151408;1;16;12;10;38
1367;5;181013;5;19;16;42;77
1368;5;151510;8;16;18;32;66
1369;5;151311;7;12;5;26;43
1370;5;180811;5;14;19;57;90
1371;5;180511;4;11;17;40;68
1372;5;151409;1;12;5;50;67
1373;5;180612;1;19;12;45;76
1374;5;170916;11;6;7;24;37
1375;5;180713;11;20;9;54;83
1376;5;180812;5;11;17;55;83
1377;5;180118;9;8;10;26;44
1378;5;181014;5;14;6;8;28
1379;5;180418;4;12;16;22;50
1380;5;181015;5;10;5;51;66
1381;5;180613;1;8;10;9;27
1382;5;151410;1;15;17;24;56
1383;5;180714;11;18;8;50;76
1384;5;180813;5;11;6;59;76
1385;5;180317;5;7;19;17;43
1386;5;170917;11;14;18;38;70
1387;5;180512;4;12;16;42;70
1388;5;151312;7;8;14;10;32
1389;5;170918;11;11;13;23;47
1390;5;180216;8;18;13;41;72
1391;5;151411;1;7;18;18;43
1392;5;151511;8;8;20;6;34
1393;5;180419;4;5;14;31;50
1394;5;151512;8;12;14;20;46
1395;5;180614;1;10;15;11;36
1396;5;180715;11;17;9;48;74
1397;5;180513;4;17;9;26;52
1398;5;151313;7;16;6;55;77
1399;5;180615;1;16;10;28;54
1400;5;180716;11;7;11;36;54
1401;5;180814;5;20;5;7;32
1402;5;180318;5;20;12;58;90
1403;5;180616;1;15;10;43;68
1404;5;181016;5;20;6;46;72
1405;5;180119;9;15;7;44;66
1406;5;151412;1;11;11;52;74
1407;5;180420;4;12;20;59;91
1408;5;180319;5;19;18;44;81
1409;5;180717;11;20;20;57;97
1410;5;151413;1;11;13;27;51
1411;5;180815;5;11;9;19;39
1412;5;151513;8;10;7;37;54
1413;5;181017;5;18;11;49;78
1414;5;181018;5;6;5;8;19
1415;5;151514;8;18;9;60;87
1416;5;180120;9;5;9;41;55
1417;5;180617;1;13;13;23;49
1418;5;180718;11;19;20;21;60
1419;5;180816;5;16;8;26;50
1420;5;180514;4;10;12;17;39
1421;5;180421;4;7;7;43;57
1422;5;180618;1;11;12;17;40
1423;5;151515;8;13;7;15;35
1424;5;151314;7;18;18;53;89
1425;5;180217;8;12;9;15;36
1426;5;180320;5;16;16;27;59
1427;5;180121;9;16;6;9;31
1428;5;181019;5;17;9;7;33
1429;5;151414;1;10;17;56;83
1430;5;180122;9;13;18;18;49
1431;5;180218;8;8;14;42;64
1432;5;180515;4;15;9;26;50
1433;5;180321;5;8;15;34;57
1434;5;180219;8;13;18;51;82
1435;5;180422;4;17;12;7;36
1436;5;180719;11;6;8;10;24
1437;5;180817;5;14;8;5;27
1438;5;181020;5;15;19;47;81
1439;5;180220;8;16;17;48;81
1440;5;181021;5;17;20;59;96
1441;5;151415;1;10;9;44;63
1442;5;180322;5;15;16;26;57
1443;5;180516;4;14;16;25;55
1444;5;180619;1;6;13;57;76
1445;5;180720;11;13;18;25;56
1446;5;180818;5;9;11;20;40
1447;5;181022;5;12;19;19;50
1448;5;180819;5;8;7;16;31
1449;5;151315;7;20;16;49;85
1450;5;180517;4;10;10;38;58
1451;5;151416;1;8;18;6;32
1452;5;180518;4;7;16;28;51
1453;5;151516;8;11;8;37;56
1454;5;180423;4;19;17;6;42
1455;5;151316;7;11;7;30;48
1456;5;151417;1;20;17;20;57
1457;5;180221;8;14;17;15;46
1458;5;151517;8;11;19;45;75
1459;5;180323;5;19;14;57;90
1460;5;180820;5;16;16;52;84
1461;5;180222;8;9;12;38;59
1462;5;181023;5;7;18;34;59
1463;5;181024;5;12;19;25;56
1464;5;180821;5;15;9;42;66
1465;5;151317;7;19;5;60;84
1466;5;180519;4;8;13;42;63
1467;5;180123;9;19;8;35;62
1468;5;180620;1;6;14;12;32
1469;5;180424;4;10;7;36;53
1470;5;180223;8;6;9;39;54
1471;5;180721;11;9;14;55;78
1472;5;180324;5;14;9;14;37
1473;5;180520;4;12;17;39;68
1474;5;180822;5;13;16;58;87
1475;5;181025;5;9;7;14;30
1476;5;151418;1;11;13;33;57
1477;5;180224;8;20;5;29;54
1478;5;180722;11;6;11;37;54
1479;5;180425;4;16;19;17;52
1480;5;180521;4;11;10;57;78
1481;5;180621;1;7;5;7;19
1482;5;180124;9;7;20;49;76
1483;5;180325;5;9;11;34;54
1484;5;151419;1;18;19;42;79
1485;5;180723;11;12;18;19;49
1486;5;180823;5;7;6;23;36
1487;5;180125;9;13;16;28;57
1488;5;151518;8;19;20;38;77
1489;5;180522;4;19;12;55;86
1490;5;180622;1;12;11;40;63
1491;5;180523;4;19;20;14;53
1492;5;180225;8;13;17;25;55
1493;5;180524;4;11;9;36;56
1494;5;180126;9;8;17;5;30
1495;5;180326;5;8;11;19;38
1496;5;180724;11;6;15;31;52
1497;5;151318;7;18;16;18;52
1498;5;180127;9;13;7;23;43
1499;5;180426;4;7;17;5;29
1500;5;180824;5;16;20;52;88
1501;5;180825;5;14;14;6;34
1502;5;180525;4;14;17;9;40
1503;5;180526;4;13;18;50;81
1504;5;180623;1;11;10;39;60
1505;5;180624;1;6;9;10;25
1506;6;151301;10;6;8;23;37
1507;6;180101;7;11;12;59;82
1508;6;180501;6;9;16;40;65
1509;6;180701;1;11;6;16;33
1510;6;180201;3;13;14;14;41
1511;6;180301;1;19;5;34;58
1512;6;151501;9;12;15;23;50
1513;6;170901;9;13;10;39;62
1514;6;151302;10;13;5;45;63
1515;6;180801;5;6;11;48;65
1516;6;181001;9;17;19;15;51
1517;6;180102;7;14;8;42;64
1518;6;180401;9;9;8;12;29
1519;6;180502;6;11;6;38;55
1520;6;180202;3;20;18;40;78
1521;6;180302;1;16;19;7;42
1522;6;180601;1;6;10;12;28
1523;6;180303;1;14;12;11;37
1524;6;180402;9;12;13;32;57
1525;6;180702;1;10;20;58;88
1526;6;180103;7;10;10;60;80
1527;6;170902;9;10;17;57;84
1528;6;180203;3;10;6;22;38
1529;6;180802;5;17;12;54;83
1530;6;180503;6;9;17;33;59
1531;6;180304;1;19;15;59;93
1532;6;180403;9;14;20;42;76
1533;6;180602;1;16;12;22;50
1534;6;180703;1;19;16;13;48
1535;6;151401;9;8;18;27;53
1536;6;180104;7;11;16;7;34
1537;6;170903;9;7;13;47;67
1538;6;180105;7;6;12;57;75
1539;6;180204;3;18;14;48;80
1540;6;180305;1;10;9;41;60
1541;6;170904;9;19;15;36;70
1542;6;180404;9;6;9;52;67
1543;6;180106;7;18;12;5;35
1544;6;151303;10;8;17;59;84
1545;6;181002;9;7;18;40;65
1546;6;180704;1;12;6;8;26
1547;6;151402;9;15;18;9;42
1548;6;180504;6;18;7;32;57
1549;6;151304;10;6;12;60;78
1550;6;151502;9;9;19;6;34
1551;6;180705;1;7;9;10;26
1552;6;180603;1;11;11;27;49
1553;6;180803;5;13;8;6;27
1554;6;180306;1;17;12;57;86
1555;6;151503;9;11;10;42;63
1556;6;180205;3;18;20;54;92
1557;6;170905;9;6;18;58;82
1558;6;181003;9;5;17;22;44
1559;6;180405;9;6;8;57;71
1560;6;151305;10;17;8;11;36
1561;6;180307;1;10;12;35;57
1562;6;181004;9;16;10;7;33
1563;6;180406;9;7;15;56;78
1564;6;180505;6;9;6;52;67
1565;6;170906;9;20;5;28;53
1566;6;180604;1;15;19;12;46
1567;6;180308;1;8;20;44;72
1568;6;151403;9;16;20;45;81
1569;6;180206;3;14;8;23;45
1570;6;180407;9;9;15;28;52
1571;6;180706;1;11;12;57;80
1572;6;180107;7;17;5;32;54
1573;6;180804;5;16;15;45;76
1574;6;180207;3;16;7;31;54
1575;6;151504;9;18;5;38;61
1576;6;180408;9;16;16;24;56
1577;6;170907;9;18;19;23;60
1578;6;180108;7;14;9;30;53
1579;6;180309;1;13;18;16;47
1580;6;181005;9;10;7;10;27
1581;6;180605;1;20;10;54;84
1582;6;180109;7;17;9;54;80
1583;6;151306;10;14;6;48;68
1584;6;180707;1;14;6;53;73
1585;6;180110;7;11;14;21;46
1586;6;180409;9;17;17;29;63
1587;6;170908;9;15;9;46;70
1588;6;180506;6;5;20;60;85
1589;6;180606;1;13;6;28;47
1590;6;151404;9;5;18;33;56
1591;6;180805;5;15;11;42;68
1592;6;151505;9;9;12;40;61
1593;6;180410;9;17;19;45;81
1594;6;151307;10;17;16;5;38
1595;6;180310;1;12;10;33;55
1596;6;170909;9;14;11;40;65
1597;6;181006;9;9;17;26;52
1598;6;180111;7;5;14;11;30
1599;6;170910;9;9;18;22;49
1600;6;151506;9;11;8;33;52
1601;6;180311;1;8;14;7;29
1602;6;180112;7;13;8;55;76
1603;6;180708;1;10;17;56;83
1604;6;180507;6;10;12;9;31
1605;6;180607;1;8;19;38;65
1606;6;180709;1;20;10;7;37
1607;6;180806;5;18;6;17;41
1608;6;181007;9;9;16;13;38
1609;6;180411;9;18;18;28;64
1610;6;180208;3;18;18;36;72
1611;6;180312;1;5;17;19;41
1612;6;180412;9;18;15;21;54
1613;6;180113;7;20;10;58;88
1614;6;181008;9;17;14;52;83
1615;6;180508;6;11;19;59;89
1616;6;151308;10;6;18;47;71
1617;6;151405;9;12;8;50;70
1618;6;180608;1;5;18;37;60
1619;6;151507;9;5;18;45;68
1620;6;180209;3;16;6;60;82
1621;6;180313;1;7;17;10;34
1622;6;180413;9;20;17;25;62
1623;6;180114;7;17;14;54;85
1624;6;180210;3;9;10;14;33
1625;6;180710;1;20;10;40;70
1626;6;180807;5;16;8;48;72
1627;6;180211;3;19;16;6;41
1628;6;180115;7;16;9;30;55
1629;6;180212;3;5;18;22;45
1630;6;180414;9;18;19;33;70
1631;6;180314;1;19;10;18;47
1632;6;180213;3;13;18;55;86
1633;6;181009;9;19;20;52;91
1634;6;180509;6;17;13;13;43
1635;6;180808;5;20;7;50;77
1636;6;180415;9;18;16;24;58
1637;6;180609;1;11;20;8;39
1638;6;151406;9;9;12;39;60
1639;6;151508;9;6;15;20;41
1640;6;180116;7;20;16;5;41
1641;6;180315;1;9;13;36;58
1642;6;181010;9;14;17;34;65
1643;6;180416;9;8;11;5;24
1644;6;180117;7;8;20;58;86
1645;6;170911;9;7;16;48;71
1646;6;180610;1;13;20;7;40
1647;6;170912;9;13;7;12;32
1648;6;180711;1;9;11;48;68
1649;6;170913;9;12;7;32;51
1650;6;180809;5;15;5;50;70
1651;6;181011;9;14;13;25;52
1652;6;170914;9;12;5;41;58
1653;6;180214;3;15;12;9;36
1654;6;180316;1;20;18;53;91
1655;6;170915;9;13;20;24;57
1656;6;151309;10;9;16;14;39
1657;6;151407;9;10;18;5;33
1658;6;180510;6;15;20;9;44
1659;6;151509;9;14;17;9;40
1660;6;151310;10;7;9;38;54
1661;6;180215;3;14;12;28;54
1662;6;180611;1;5;5;16;26
1663;6;180712;1;11;15;19;45
1664;6;180810;5;5;11;22;38
1665;6;181012;9;6;13;51;70
1666;6;180417;9;20;5;55;80
1667;6;151408;9;19;16;45;80
1668;6;181013;9;15;11;26;52
1669;6;151510;9;8;11;44;63
1670;6;151311;10;19;16;25;60
1671;6;180811;5;11;12;16;39
1672;6;180511;6;16;9;23;48
1673;6;151409;9;5;6;28;39
1674;6;180612;1;10;11;36;57
1675;6;170916;9;16;17;12;45
1676;6;180713;1;18;9;20;47
1677;6;180812;5;13;19;52;84
1678;6;180118;7;14;6;60;80
1679;6;181014;9;7;18;16;41
1680;6;180418;9;7;14;13;34
1681;6;181015;9;7;9;50;66
1682;6;180613;1;13;10;58;81
1683;6;151410;9;8;20;15;43
1684;6;180714;1;18;18;7;43
1685;6;180813;5;19;15;60;94
1686;6;180317;1;13;13;13;39
1687;6;170917;9;6;18;28;52
1688;6;180512;6;12;20;14;46
1689;6;151312;10;13;6;39;58
1690;6;170918;9;11;10;20;41
1691;6;180216;3;7;16;28;51
1692;6;151411;9;5;5;41;51
1693;6;151511;9;12;14;5;31
1694;6;180419;9;15;13;53;81
1695;6;151512;9;12;7;43;62
1696;6;180614;1;13;10;57;80
1697;6;180715;1;13;11;52;76
1698;6;180513;6;16;12;40;68
1699;6;151313;10;18;11;36;65
1700;6;180615;1;11;6;49;66
1701;6;180716;1;13;14;52;79
1702;6;180814;5;15;12;6;33
1703;6;180318;1;20;20;35;75
1704;6;180616;1;16;18;34;68
1705;6;181016;9;5;17;49;71
1706;6;180119;7;13;19;35;67
1707;6;151412;9;17;6;18;41
1708;6;180420;9;14;15;25;54
1709;6;180319;1;18;7;16;41
1710;6;180717;1;15;17;58;90
1711;6;151413;9;9;9;17;35
1712;6;180815;5;12;8;41;61
1713;6;151513;9;17;13;13;43
1714;6;181017;9;20;13;34;67
1715;6;181018;9;7;6;58;71
1716;6;151514;9;18;18;58;94
1717;6;180120;7;7;16;42;65
1718;6;180617;1;16;18;13;47
1719;6;180718;1;20;6;58;84
1720;6;180816;5;8;9;40;57
1721;6;180514;6;17;12;8;37
1722;6;180421;9;14;12;24;50
1723;6;180618;1;14;19;21;54
1724;6;151515;9;8;18;57;83
1725;6;151314;10;6;5;51;62
1726;6;180217;3;16;7;30;53
1727;6;180320;1;12;18;59;89
1728;6;180121;7;20;8;20;48
1729;6;181019;9;8;5;57;70
1730;6;151414;9;8;8;35;51
1731;6;180122;7;17;8;51;76
1732;6;180218;3;10;6;27;43
1733;6;180515;6;18;6;13;37
1734;6;180321;1;9;8;57;74
1735;6;180219;3;10;14;14;38
1736;6;180422;9;15;13;42;70
1737;6;180719;1;7;17;5;29
1738;6;180817;5;5;11;11;27
1739;6;181020;9;19;8;8;35
1740;6;180220;3;18;7;37;62
1741;6;181021;9;5;6;37;48
1742;6;151415;9;10;18;16;44
1743;6;180322;1;16;18;59;93
1744;6;180516;6;14;17;5;36
1745;6;180619;1;7;17;26;50
1746;6;180720;1;18;5;8;31
1747;6;180818;5;20;13;36;69
1748;6;181022;9;6;7;9;22
1749;6;180819;5;20;10;50;80
1750;6;151315;10;20;15;45;80
1751;6;180517;6;18;5;40;63
1752;6;151416;9;9;5;51;65
1753;6;180518;6;10;5;56;71
1754;6;151516;9;14;5;14;33
1755;6;180423;9;7;9;49;65
1756;6;151316;10;9;12;42;63
1757;6;151417;9;18;12;55;85
1758;6;180221;3;14;15;5;34
1759;6;151517;9;9;6;29;44
1760;6;180323;1;16;15;44;75
1761;6;180820;5;15;17;34;66
1762;6;180222;3;13;6;35;54
1763;6;181023;9;10;16;32;58
1764;6;181024;9;10;19;34;63
1765;6;180821;5;16;16;35;67
1766;6;151317;10;6;15;29;50
1767;6;180519;6;18;15;31;64
1768;6;180123;7;13;18;33;64
1769;6;180620;1;14;17;34;65
1770;6;180424;9;8;19;12;39
1771;6;180223;3;12;13;39;64
1772;6;180721;1;7;18;33;58
1773;6;180324;1;13;16;38;67
1774;6;180520;6;18;15;36;69
1775;6;180822;5;12;20;48;80
1776;6;181025;9;18;12;30;60
1777;6;151418;9;7;20;46;73
1778;6;180224;3;19;5;46;70
1779;6;180722;1;16;13;23;52
1780;6;180425;9;17;7;24;48
1781;6;180521;6;13;13;48;74
1782;6;180621;1;14;18;40;72
1783;6;180124;7;17;17;36;70
1784;6;180325;1;17;6;27;50
1785;6;151419;9;15;14;59;88
1786;6;180723;1;5;14;55;74
1787;6;180823;5;12;8;26;46
1788;6;180125;7;11;18;27;56
1789;6;151518;9;19;19;43;81
1790;6;180522;6;15;9;34;58
1791;6;180622;1;7;7;40;54
1792;6;180523;6;8;9;30;47
1793;6;180225;3;13;14;35;62
1794;6;180524;6;9;19;24;52
1795;6;180126;7;14;17;21;52
1796;6;180326;1;9;11;34;54
1797;6;180724;1;17;13;31;61
1798;6;151318;10;14;5;41;60
1799;6;180127;7;14;14;6;34
1800;6;180426;9;16;11;9;36
1801;6;180824;5;17;17;56;90
1802;6;180825;5;13;17;28;58
1803;6;180525;6;13;19;16;48
1804;6;180526;6;5;8;12;25
1805;6;180623;1;12;14;51;77
1806;6;180624;1;8;18;11;37
1807;7;151301;11;7;16;10;33
1808;7;180101;9;16;16;32;64
1809;7;180501;10;13;18;37;68
1810;7;180701;10;19;5;53;77
1811;7;180201;10;15;9;57;81
1812;7;180301;5;8;17;9;34
1813;7;151501;4;13;19;17;49
1814;7;170901;8;20;12;36;68
1815;7;151302;11;15;6;45;66
1816;7;180801;7;6;8;33;47
1817;7;181001;9;11;20;9;40
1818;7;180102;9;16;19;44;79
1819;7;180401;10;6;18;60;84
1820;7;180502;10;5;7;51;63
1821;7;180202;10;8;13;54;75
1822;7;180302;5;15;11;42;68
1823;7;180601;6;18;16;46;80
1824;7;180303;5;5;14;52;71
1825;7;180402;10;12;12;41;65
1826;7;180702;10;6;6;30;42
1827;7;180103;9;11;12;43;66
1828;7;170902;8;16;12;38;66
1829;7;180203;10;18;16;22;56
1830;7;180802;7;13;16;25;54
1831;7;180503;10;20;7;46;73
1832;7;180304;5;8;13;25;46
1833;7;180403;10;14;6;32;52
1834;7;180602;6;15;16;20;51
1835;7;180703;10;16;12;27;55
1836;7;151401;10;5;9;52;66
1837;7;180104;9;5;20;43;68
1838;7;170903;8;10;13;25;48
1839;7;180105;9;18;10;39;67
1840;7;180204;10;20;15;27;62
1841;7;180305;5;19;17;32;68
1842;7;170904;8;8;10;57;75
1843;7;180404;10;17;13;59;89
1844;7;180106;9;19;5;51;75
1845;7;151303;11;10;12;33;55
1846;7;181002;9;7;17;38;62
1847;7;180704;10;10;8;13;31
1848;7;151402;10;11;6;40;57
1849;7;180504;10;10;9;57;76
1850;7;151304;11;13;14;32;59
1851;7;151502;4;5;18;9;32
1852;7;180705;10;16;15;13;44
1853;7;180603;6;11;12;12;35
1854;7;180803;7;20;20;11;51
1855;7;180306;5;7;19;47;73
1856;7;151503;4;18;7;16;41
1857;7;180205;10;18;18;38;74
1858;7;170905;8;11;14;49;74
1859;7;181003;9;15;10;38;63
1860;7;180405;10;19;8;35;62
1861;7;151305;11;6;5;43;54
1862;7;180307;5;5;15;52;72
1863;7;181004;9;14;11;28;53
1864;7;180406;10;13;16;48;77
1865;7;180505;10;12;9;57;78
1866;7;170906;8;6;18;47;71
1867;7;180604;6;17;18;9;44
1868;7;180308;5;20;9;40;69
1869;7;151403;10;17;10;21;48
1870;7;180206;10;11;20;8;39
1871;7;180407;10;18;8;55;81
1872;7;180706;10;12;6;7;25
1873;7;180107;9;13;11;59;83
1874;7;180804;7;19;14;53;86
1875;7;180207;10;20;15;54;89
1876;7;151504;4;11;13;8;32
1877;7;180408;10;6;19;55;80
1878;7;170907;8;19;10;23;52
1879;7;180108;9;11;12;23;46
1880;7;180309;5;18;17;25;60
1881;7;181005;9;15;7;41;63
1882;7;180605;6;15;9;45;69
1883;7;180109;9;12;16;27;55
1884;7;151306;11;13;7;9;29
1885;7;180707;10;9;13;5;27
1886;7;180110;9;5;8;52;65
1887;7;180409;10;19;12;40;71
1888;7;170908;8;17;6;50;73
1889;7;180506;10;18;17;13;48
1890;7;180606;6;15;15;23;53
1891;7;151404;10;17;20;55;92
1892;7;180805;7;15;16;53;84
1893;7;151505;4;6;10;28;44
1894;7;180410;10;8;16;15;39
1895;7;151307;11;6;19;27;52
1896;7;180310;5;16;8;58;82
1897;7;170909;8;12;13;7;32
1898;7;181006;9;18;19;57;94
1899;7;180111;9;15;9;51;75
1900;7;170910;8;9;19;27;55
1901;7;151506;4;8;5;9;22
1902;7;180311;5;19;17;35;71
1903;7;180112;9;11;14;48;73
1904;7;180708;10;5;18;19;42
1905;7;180507;10;10;20;15;45
1906;7;180607;6;17;14;49;80
1907;7;180709;10;5;11;23;39
1908;7;180806;7;5;18;43;66
1909;7;181007;9;12;12;39;63
1910;7;180411;10;7;11;26;44
1911;7;180208;10;11;13;17;41
1912;7;180312;5;7;19;55;81
1913;7;180412;10;8;12;37;57
1914;7;180113;9;14;11;9;34
1915;7;181008;9;15;20;33;68
1916;7;180508;10;5;19;55;79
1917;7;151308;11;7;17;40;64
1918;7;151405;10;20;5;41;66
1919;7;180608;6;13;9;25;47
1920;7;151507;4;16;8;46;70
1921;7;180209;10;5;20;52;77
1922;7;180313;5;13;11;25;49
1923;7;180413;10;8;11;11;30
1924;7;180114;9;17;16;43;76
1925;7;180210;10;10;19;8;37
1926;7;180710;10;5;19;16;40
1927;7;180807;7;12;18;51;81
1928;7;180211;10;16;15;42;73
1929;7;180115;9;14;13;16;43
1930;7;180212;10;6;5;59;70
1931;7;180414;10;8;15;22;45
1932;7;180314;5;6;19;11;36
1933;7;180213;10;20;5;6;31
1934;7;181009;9;6;11;39;56
1935;7;180509;10;5;19;14;38
1936;7;180808;7;16;10;19;45
1937;7;180415;10;19;11;15;45
1938;7;180609;6;6;6;29;41
1939;7;151406;10;19;10;31;60
1940;7;151508;4;15;5;52;72
1941;7;180116;9;9;19;54;82
1942;7;180315;5;6;11;45;62
1943;7;181010;9;12;16;44;72
1944;7;180416;10;6;13;31;50
1945;7;180117;9;18;20;38;76
1946;7;170911;8;17;17;12;46
1947;7;180610;6;10;12;14;36
1948;7;170912;8;16;18;15;49
1949;7;180711;10;18;18;14;50
1950;7;170913;8;16;13;56;85
1951;7;180809;7;9;8;8;25
1952;7;181011;9;10;20;57;87
1953;7;170914;8;10;12;55;77
1954;7;180214;10;6;6;37;49
1955;7;180316;5;7;20;57;84
1956;7;170915;8;6;12;12;30
1957;7;151309;11;12;8;52;72
1958;7;151407;10;14;16;44;74
1959;7;180510;10;9;17;20;46
1960;7;151509;4;9;15;17;41
1961;7;151310;11;9;6;7;22
1962;7;180215;10;17;12;45;74
1963;7;180611;6;6;7;18;31
1964;7;180712;10;11;19;18;48
1965;7;180810;7;17;14;18;49
1966;7;181012;9;20;11;30;61
1967;7;180417;10;11;19;57;87
1968;7;151408;10;20;11;15;46
1969;7;181013;9;6;15;58;79
1970;7;151510;4;11;6;42;59
1971;7;151311;11;7;12;45;64
1972;7;180811;7;9;20;57;86
1973;7;180511;10;12;7;19;38
1974;7;151409;10;11;11;41;63
1975;7;180612;6;14;13;55;82
1976;7;170916;8;15;17;56;88
1977;7;180713;10;14;12;11;37
1978;7;180812;7;12;6;26;44
1979;7;180118;9;8;15;5;28
1980;7;181014;9;19;12;36;67
1981;7;180418;10;5;18;8;31
1982;7;181015;9;11;12;29;52
1983;7;180613;6;12;19;19;50
1984;7;151410;10;13;10;27;50
1985;7;180714;10;12;7;20;39
1986;7;180813;7;17;6;24;47
1987;7;180317;5;8;7;10;25
1988;7;170917;8;19;13;17;49
1989;7;180512;10;18;14;29;61
1990;7;151312;11;9;20;47;76
1991;7;170918;8;11;6;6;23
1992;7;180216;10;18;15;56;89
1993;7;151411;10;6;13;6;25
1994;7;151511;4;20;12;30;62
1995;7;180419;10;7;9;6;22
1996;7;151512;4;12;7;28;47
1997;7;180614;6;15;15;5;35
1998;7;180715;10;10;9;21;40
1999;7;180513;10;15;6;41;62
2000;7;151313;11;6;9;38;53
2001;7;180615;6;8;13;60;81
2002;7;180716;10;17;13;25;55
2003;7;180814;7;18;7;49;74
2004;7;180318;5;11;17;58;86
2005;7;180616;6;16;12;31;59
2006;7;181016;9;19;12;20;51
2007;7;180119;9;15;11;45;71
2008;7;151412;10;8;5;18;31
2009;7;180420;10;13;6;36;55
2010;7;180319;5;14;10;9;33
2011;7;180717;10;7;7;26;40
2012;7;151413;10;7;19;18;44
2013;7;180815;7;16;9;29;54
2014;7;151513;4;7;7;32;46
2015;7;181017;9;5;18;41;64
2016;7;181018;9;12;15;37;64
2017;7;151514;4;17;12;17;46
2018;7;180120;9;17;10;7;34
2019;7;180617;6;9;11;5;25
2020;7;180718;10;14;18;16;48
2021;7;180816;7;17;19;37;73
2022;7;180514;10;5;8;35;48
2023;7;180421;10;19;16;39;74
2024;7;180618;6;18;5;6;29
2025;7;151515;4;14;17;51;82
2026;7;151314;11;15;18;31;64
2027;7;180217;10;16;10;36;62
2028;7;180320;5;5;9;59;73
2029;7;180121;9;12;17;26;55
2030;7;181019;9;15;9;27;51
2031;7;151414;10;18;14;34;66
2032;7;180122;9;15;14;42;71
2033;7;180218;10;8;16;11;35
2034;7;180515;10;6;6;46;58
2035;7;180321;5;5;8;15;28
2036;7;180219;10;5;18;7;30
2037;7;180422;10;6;18;11;35
2038;7;180719;10;19;11;53;83
2039;7;180817;7;19;8;49;76
2040;7;181020;9;15;7;27;49
2041;7;180220;10;20;6;23;49
2042;7;181021;9;14;11;26;51
2043;7;151415;10;6;20;43;69
2044;7;180322;5;6;14;52;72
2045;7;180516;10;19;9;8;36
2046;7;180619;6;18;14;21;53
2047;7;180720;10;17;11;52;80
2048;7;180818;7;15;15;26;56
2049;7;181022;9;7;12;34;53
2050;7;180819;7;7;9;44;60
2051;7;151315;11;14;5;59;78
2052;7;180517;10;7;7;6;20
2053;7;151416;10;5;7;11;23
2054;7;180518;10;17;11;57;85
2055;7;151516;4;5;10;9;24
2056;7;180423;10;8;19;17;44
2057;7;151316;11;11;10;50;71
2058;7;151417;10;10;13;16;39
2059;7;180221;10;18;9;43;70
2060;7;151517;4;12;19;54;85
2061;7;180323;5;5;14;40;59
2062;7;180820;7;19;16;21;56
2063;7;180222;10;14;16;19;49
2064;7;181023;9;6;16;23;45
2065;7;181024;9;9;12;18;39
2066;7;180821;7;19;16;24;59
2067;7;151317;11;14;18;50;82
2068;7;180519;10;5;10;24;39
2069;7;180123;9;20;11;42;73
2070;7;180620;6;9;14;56;79
2071;7;180424;10;7;6;31;44
2072;7;180223;10;10;9;58;77
2073;7;180721;10;20;10;44;74
2074;7;180324;5;12;17;30;59
2075;7;180520;10;9;10;41;60
2076;7;180822;7;13;10;12;35
2077;7;181025;9;13;11;45;69
2078;7;151418;10;18;13;26;57
2079;7;180224;10;15;8;29;52
2080;7;180722;10;16;19;5;40
2081;7;180425;10;7;6;38;51
2082;7;180521;10;11;16;16;43
2083;7;180621;6;5;8;60;73
2084;7;180124;9;11;14;53;78
2085;7;180325;5;6;18;42;66
2086;7;151419;10;18;14;26;58
2087;7;180723;10;20;10;37;67
2088;7;180823;7;13;5;57;75
2089;7;180125;9;18;20;32;70
2090;7;151518;4;11;18;21;50
2091;7;180522;10;7;5;39;51
2092;7;180622;6;20;16;35;71
2093;7;180523;10;14;10;22;46
2094;7;180225;10;9;11;48;68
2095;7;180524;10;8;18;36;62
2096;7;180126;9;11;11;38;60
2097;7;180326;5;13;15;35;63
2098;7;180724;10;20;17;54;91
2099;7;151318;11;9;15;35;59
2100;7;180127;9;5;16;26;47
2101;7;180426;10;20;6;43;69
2102;7;180824;7;11;11;11;33
2103;7;180825;7;8;19;51;78
2104;7;180525;10;19;8;32;59
2105;7;180526;10;9;10;48;67
2106;7;180623;6;15;12;43;70
2107;7;180624;6;5;16;27;48
2108;8;151301;10;10;18;11;39
2109;8;180101;6;15;20;9;44
2110;8;180501;1;10;18;45;73
2111;8;180701;9;12;18;34;64
2112;8;180201;8;15;16;48;79
2113;8;180301;7;20;9;18;47
2114;8;151501;8;6;13;43;62
2115;8;170901;4;18;19;41;78
2116;8;151302;10;9;7;25;41
2117;8;180801;2;17;7;13;37
2118;8;181001;4;6;11;35;52
2119;8;180102;6;8;20;47;75
2120;8;180401;6;17;6;41;64
2121;8;180502;1;8;14;40;62
2122;8;180202;8;5;12;7;24
2123;8;180302;7;20;13;54;87
2124;8;180601;8;17;10;5;32
2125;8;180303;7;13;6;57;76
2126;8;180402;6;7;6;50;63
2127;8;180702;9;8;8;58;74
2128;8;180103;6;10;17;50;77
2129;8;170902;4;8;6;20;34
2130;8;180203;8;19;7;38;64
2131;8;180802;2;19;14;46;79
2132;8;180503;1;7;9;26;42
2133;8;180304;7;7;11;52;70
2134;8;180403;6;13;14;31;58
2135;8;180602;8;18;9;41;68
2136;8;180703;9;14;11;7;32
2137;8;151401;11;7;18;56;81
2138;8;180104;6;20;8;6;34
2139;8;170903;4;15;7;19;41
2140;8;180105;6;9;8;26;43
2141;8;180204;8;16;19;55;90
2142;8;180305;7;10;9;58;77
2143;8;170904;4;15;16;16;47
2144;8;180404;6;6;5;26;37
2145;8;180106;6;13;19;57;89
2146;8;151303;10;19;16;45;80
2147;8;181002;4;10;14;53;77
2148;8;180704;9;13;15;48;76
2149;8;151402;11;5;17;7;29
2150;8;180504;1;12;13;46;71
2151;8;151304;10;11;18;57;86
2152;8;151502;8;20;7;39;66
2153;8;180705;9;15;18;36;69
2154;8;180603;8;18;11;33;62
2155;8;180803;2;5;13;60;78
2156;8;180306;7;15;8;48;71
2157;8;151503;8;17;10;10;37
2158;8;180205;8;11;11;16;38
2159;8;170905;4;19;7;30;56
2160;8;181003;4;16;14;24;54
2161;8;180405;6;17;6;36;59
2162;8;151305;10;7;20;27;54
2163;8;180307;7;7;17;24;48
2164;8;181004;4;8;5;21;34
2165;8;180406;6;12;18;34;64
2166;8;180505;1;19;9;48;76
2167;8;170906;4;7;15;14;36
2168;8;180604;8;17;5;48;70
2169;8;180308;7;7;8;28;43
2170;8;151403;11;8;12;45;65
2171;8;180206;8;18;5;5;28
2172;8;180407;6;19;18;19;56
2173;8;180706;9;15;7;36;58
2174;8;180107;6;9;16;38;63
2175;8;180804;2;17;19;19;55
2176;8;180207;8;17;20;38;75
2177;8;151504;8;20;12;8;40
2178;8;180408;6;10;5;30;45
2179;8;170907;4;11;10;44;65
2180;8;180108;6;5;15;18;38
2181;8;180309;7;20;11;15;46
2182;8;181005;4;13;9;54;76
2183;8;180605;8;19;17;45;81
2184;8;180109;6;8;15;18;41
2185;8;151306;10;20;9;53;82
2186;8;180707;9;20;8;50;78
2187;8;180110;6;10;20;18;48
2188;8;180409;6;8;17;26;51
2189;8;170908;4;17;19;36;72
2190;8;180506;1;17;17;31;65
2191;8;180606;8;14;13;10;37
2192;8;151404;11;6;15;5;26
2193;8;180805;2;9;15;44;68
2194;8;151505;8;8;14;30;52
2195;8;180410;6;9;7;52;68
2196;8;151307;10;19;6;29;54
2197;8;180310;7;6;10;17;33
2198;8;170909;4;20;8;49;77
2199;8;181006;4;5;9;34;48
2200;8;180111;6;19;7;22;48
2201;8;170910;4;20;14;20;54
2202;8;151506;8;14;10;28;52
2203;8;180311;7;5;18;34;57
2204;8;180112;6;17;19;31;67
2205;8;180708;9;15;5;58;78
2206;8;180507;1;7;17;11;35
2207;8;180607;8;5;12;58;75
2208;8;180709;9;19;12;39;70
2209;8;180806;2;13;9;27;49
2210;8;181007;4;19;7;26;52
2211;8;180411;6;18;10;57;85
2212;8;180208;8;7;8;43;58
2213;8;180312;7;7;8;13;28
2214;8;180412;6;8;17;13;38
2215;8;180113;6;20;12;15;47
2216;8;181008;4;20;18;29;67
2217;8;180508;1;14;6;38;58
2218;8;151308;10;20;9;53;82
2219;8;151405;11;14;16;16;46
2220;8;180608;8;14;12;5;31
2221;8;151507;8;15;19;11;45
2222;8;180209;8;13;5;32;50
2223;8;180313;7;7;12;25;44
2224;8;180413;6;14;12;21;47
2225;8;180114;6;5;6;42;53
2226;8;180210;8;8;18;35;61
2227;8;180710;9;16;5;23;44
2228;8;180807;2;18;17;22;57
2229;8;180211;8;16;5;57;78
2230;8;180115;6;16;8;55;79
2231;8;180212;8;19;20;6;45
2232;8;180414;6;10;16;40;66
2233;8;180314;7;16;15;32;63
2234;8;180213;8;11;15;39;65
2235;8;181009;4;9;20;56;85
2236;8;180509;1;7;12;6;25
2237;8;180808;2;7;9;38;54
2238;8;180415;6;18;8;40;66
2239;8;180609;8;13;7;38;58
2240;8;151406;11;10;18;56;84
2241;8;151508;8;15;6;29;50
2242;8;180116;6;10;6;15;31
2243;8;180315;7;15;13;14;42
2244;8;181010;4;19;19;32;70
2245;8;180416;6;20;20;12;52
2246;8;180117;6;12;20;47;79
2247;8;170911;4;7;10;14;31
2248;8;180610;8;15;7;33;55
2249;8;170912;4;15;12;49;76
2250;8;180711;9;9;14;44;67
2251;8;170913;4;6;5;31;42
2252;8;180809;2;16;17;18;51
2253;8;181011;4;5;18;55;78
2254;8;170914;4;11;10;21;42
2255;8;180214;8;8;18;58;84
2256;8;180316;7;5;19;41;65
2257;8;170915;4;12;20;19;51
2258;8;151309;10;17;17;57;91
2259;8;151407;11;18;9;41;68
2260;8;180510;1;5;19;48;72
2261;8;151509;8;20;10;36;66
2262;8;151310;10;7;16;6;29
2263;8;180215;8;19;20;5;44
2264;8;180611;8;16;13;13;42
2265;8;180712;9;12;15;34;61
2266;8;180810;2;7;12;42;61
2267;8;181012;4;5;9;38;52
2268;8;180417;6;5;9;35;49
2269;8;151408;11;18;6;35;59
2270;8;181013;4;6;6;43;55
2271;8;151510;8;20;5;36;61
2272;8;151311;10;14;8;9;31
2273;8;180811;2;17;15;58;90
2274;8;180511;1;10;12;44;66
2275;8;151409;11;20;18;51;89
2276;8;180612;8;9;7;49;65
2277;8;170916;4;12;9;56;77
2278;8;180713;9;5;7;49;61
2279;8;180812;2;13;15;41;69
2280;8;180118;6;17;14;27;58
2281;8;181014;4;10;19;59;88
2282;8;180418;6;18;20;46;84
2283;8;181015;4;7;11;44;62
2284;8;180613;8;9;8;51;68
2285;8;151410;11;13;9;25;47
2286;8;180714;9;7;17;24;48
2287;8;180813;2;20;8;56;84
2288;8;180317;7;10;13;17;40
2289;8;170917;4;19;16;41;76
2290;8;180512;1;16;11;21;48
2291;8;151312;10;13;18;43;74
2292;8;170918;4;18;19;49;86
2293;8;180216;8;9;17;20;46
2294;8;151411;11;20;5;20;45
2295;8;151511;8;12;6;29;47
2296;8;180419;6;11;7;28;46
2297;8;151512;8;10;12;29;51
2298;8;180614;8;11;8;12;31
2299;8;180715;9;15;20;58;93
2300;8;180513;1;5;19;25;49
2301;8;151313;10;10;18;5;33
2302;8;180615;8;9;12;20;41
2303;8;180716;9;17;13;42;72
2304;8;180814;2;6;19;56;81
2305;8;180318;7;12;5;27;44
2306;8;180616;8;19;15;13;47
2307;8;181016;4;6;17;7;30
2308;8;180119;6;19;20;33;72
2309;8;151412;11;8;20;16;44
2310;8;180420;6;14;9;46;69
2311;8;180319;7;5;13;31;49
2312;8;180717;9;14;13;35;62
2313;8;151413;11;15;14;48;77
2314;8;180815;2;16;9;35;60
2315;8;151513;8;8;10;52;70
2316;8;181017;4;9;20;55;84
2317;8;181018;4;11;12;46;69
2318;8;151514;8;13;15;38;66
2319;8;180120;6;16;5;28;49
2320;8;180617;8;16;15;51;82
2321;8;180718;9;18;13;14;45
2322;8;180816;2;16;19;36;71
2323;8;180514;1;16;16;48;80
2324;8;180421;6;10;8;39;57
2325;8;180618;8;10;10;30;50
2326;8;151515;8;12;11;35;58
2327;8;151314;10;8;6;57;71
2328;8;180217;8;18;18;25;61
2329;8;180320;7;14;12;12;38
2330;8;180121;6;18;11;46;75
2331;8;181019;4;16;20;36;72
2332;8;151414;11;12;13;18;43
2333;8;180122;6;20;20;44;84
2334;8;180218;8;17;5;14;36
2335;8;180515;1;9;18;57;84
2336;8;180321;7;13;6;37;56
2337;8;180219;8;6;11;50;67
2338;8;180422;6;6;8;33;47
2339;8;180719;9;10;7;39;56
2340;8;180817;2;18;10;13;41
2341;8;181020;4;19;16;58;93
2342;8;180220;8;5;10;48;63
2343;8;181021;4;10;7;54;71
2344;8;151415;11;13;11;39;63
2345;8;180322;7;20;7;5;32
2346;8;180516;1;18;20;7;45
2347;8;180619;8;6;15;42;63
2348;8;180720;9;6;16;58;80
2349;8;180818;2;8;18;14;40
2350;8;181022;4;17;7;26;50
2351;8;180819;2;15;13;46;74
2352;8;151315;10;10;15;13;38
2353;8;180517;1;17;17;9;43
2354;8;151416;11;6;20;13;39
2355;8;180518;1;14;11;49;74
2356;8;151516;8;9;17;19;45
2357;8;180423;6;11;17;18;46
2358;8;151316;10;17;8;50;75
2359;8;151417;11;6;16;46;68
2360;8;180221;8;18;5;9;32
2361;8;151517;8;18;6;15;39
2362;8;180323;7;14;16;16;46
2363;8;180820;2;17;7;55;79
2364;8;180222;8;14;17;54;85
2365;8;181023;4;8;7;27;42
2366;8;181024;4;9;5;13;27
2367;8;180821;2;20;19;18;57
2368;8;151317;10;8;5;23;36
2369;8;180519;1;5;19;48;72
2370;8;180123;6;5;10;43;58
2371;8;180620;8;17;8;53;78
2372;8;180424;6;8;11;55;74
2373;8;180223;8;12;5;58;75
2374;8;180721;9;12;13;45;70
2375;8;180324;7;10;9;25;44
2376;8;180520;1;19;8;28;55
2377;8;180822;2;10;19;54;83
2378;8;181025;4;8;10;35;53
2379;8;151418;11;15;8;34;57
2380;8;180224;8;13;12;51;76
2381;8;180722;9;7;6;10;23
2382;8;180425;6;12;10;46;68
2383;8;180521;1;9;7;15;31
2384;8;180621;8;8;16;15;39
2385;8;180124;6;16;6;49;71
2386;8;180325;7;10;5;14;29
2387;8;151419;11;19;13;54;86
2388;8;180723;9;7;12;23;42
2389;8;180823;2;7;9;17;33
2390;8;180125;6;17;12;6;35
2391;8;151518;8;15;9;37;61
2392;8;180522;1;13;20;31;64
2393;8;180622;8;13;11;42;66
2394;8;180523;1;12;18;17;47
2395;8;180225;8;20;19;59;98
2396;8;180524;1;9;12;60;81
2397;8;180126;6;7;11;20;38
2398;8;180326;7;6;18;53;77
2399;8;180724;9;13;10;54;77
2400;8;151318;10;6;11;33;50
2401;8;180127;6;12;19;53;84
2402;8;180426;6;16;20;32;68
2403;8;180824;2;19;11;10;40
2404;8;180825;2;17;20;11;48
2405;8;180525;1;9;18;49;76
2406;8;180526;1;18;12;49;79
2407;8;180623;8;6;10;7;23
2408;8;180624;8;20;16;28;64
2409;9;151301;6;20;12;28;60
2410;9;180101;5;11;12;26;49
2411;9;180501;6;19;17;5;41
2412;9;180701;4;6;15;41;62
2413;9;180201;5;7;15;51;73
2414;9;180301;7;20;11;21;52
2415;9;151501;7;15;13;49;77
2416;9;170901;8;7;6;50;63
2417;9;151302;6;19;16;57;92
2418;9;180801;9;18;10;37;65
2419;9;181001;11;12;10;24;46
2420;9;180102;5;15;16;25;56
2421;9;180401;7;17;7;12;36
2422;9;180502;6;14;17;28;59
2423;9;180202;5;13;14;10;37
2424;9;180302;7;15;17;48;80
2425;9;180601;8;5;18;41;64
2426;9;180303;7;8;20;28;56
2427;9;180402;7;5;15;18;38
2428;9;180702;4;13;16;23;52
2429;9;180103;5;12;9;52;73
2430;9;170902;8;18;18;9;45
2431;9;180203;5;19;5;6;30
2432;9;180802;9;15;5;56;76
2433;9;180503;6;7;15;9;31
2434;9;180304;7;11;15;17;43
2435;9;180403;7;17;19;25;61
2436;9;180602;8;17;20;23;60
2437;9;180703;4;5;14;23;42
2438;9;151401;11;13;15;37;65
2439;9;180104;5;10;18;31;59
2440;9;170903;8;17;17;41;75
2441;9;180105;5;19;20;42;81
2442;9;180204;5;12;15;43;70
2443;9;180305;7;19;18;59;96
2444;9;170904;8;13;17;6;36
2445;9;180404;7;19;15;55;89
2446;9;180106;5;18;5;52;75
2447;9;151303;6;20;9;18;47
2448;9;181002;11;16;15;40;71
2449;9;180704;4;7;5;26;38
2450;9;151402;11;17;7;31;55
2451;9;180504;6;19;20;32;71
2452;9;151304;6;18;5;13;36
2453;9;151502;7;6;11;49;66
2454;9;180705;4;12;19;48;79
2455;9;180603;8;18;20;20;58
2456;9;180803;9;10;10;44;64
2457;9;180306;7;6;12;8;26
2458;9;151503;7;9;11;39;59
2459;9;180205;5;6;18;37;61
2460;9;170905;8;19;5;21;45
2461;9;181003;11;19;11;53;83
2462;9;180405;7;14;6;41;61
2463;9;151305;6;6;17;19;42
2464;9;180307;7;11;11;12;34
2465;9;181004;11;10;16;24;50
2466;9;180406;7;15;13;9;37
2467;9;180505;6;7;18;53;78
2468;9;170906;8;11;9;25;45
2469;9;180604;8;20;16;51;87
2470;9;180308;7;11;9;52;72
2471;9;151403;11;8;13;48;69
2472;9;180206;5;17;5;35;57
2473;9;180407;7;14;19;44;77
2474;9;180706;4;6;6;29;41
2475;9;180107;5;8;5;42;55
2476;9;180804;9;16;8;45;69
2477;9;180207;5;10;6;23;39
2478;9;151504;7;14;17;47;78
2479;9;180408;7;5;16;48;69
2480;9;170907;8;14;7;20;41
2481;9;180108;5;5;19;11;35
2482;9;180309;7;9;10;27;46
2483;9;181005;11;8;15;48;71
2484;9;180605;8;10;6;51;67
2485;9;180109;5;18;14;32;64
2486;9;151306;6;20;20;18;58
2487;9;180707;4;10;14;15;39
2488;9;180110;5;11;15;36;62
2489;9;180409;7;8;17;57;82
2490;9;170908;8;11;20;54;85
2491;9;180506;6;12;6;6;24
2492;9;180606;8;11;6;17;34
2493;9;151404;11;6;12;48;66
2494;9;180805;9;8;19;29;56
2495;9;151505;7;19;15;48;82
2496;9;180410;7;10;9;45;64
2497;9;151307;6;16;8;17;41
2498;9;180310;7;8;15;7;30
2499;9;170909;8;17;13;13;43
2500;9;181006;11;16;5;39;60
2501;9;180111;5;12;9;11;32
2502;9;170910;8;7;12;46;65
2503;9;151506;7;11;7;33;51
2504;9;180311;7;6;11;52;69
2505;9;180112;5;12;19;55;86
2506;9;180708;4;16;12;37;65
2507;9;180507;6;20;20;26;66
2508;9;180607;8;12;12;10;34
2509;9;180709;4;15;10;50;75
2510;9;180806;9;5;10;45;60
2511;9;181007;11;15;18;42;75
2512;9;180411;7;18;18;21;57
2513;9;180208;5;10;11;33;54
2514;9;180312;7;10;15;19;44
2515;9;180412;7;6;12;24;42
2516;9;180113;5;17;7;16;40
2517;9;181008;11;15;5;58;78
2518;9;180508;6;12;10;5;27
2519;9;151308;6;10;7;57;74
2520;9;151405;11;12;11;30;53
2521;9;180608;8;16;15;38;69
2522;9;151507;7;15;19;53;87
2523;9;180209;5;14;10;34;58
2524;9;180313;7;15;19;43;77
2525;9;180413;7;20;6;48;74
2526;9;180114;5;13;5;26;44
2527;9;180210;5;5;18;53;76
2528;9;180710;4;16;5;36;57
2529;9;180807;9;20;9;17;46
2530;9;180211;5;9;19;7;35
2531;9;180115;5;6;8;36;50
2532;9;180212;5;17;15;33;65
2533;9;180414;7;5;16;9;30
2534;9;180314;7;15;7;52;74
2535;9;180213;5;17;17;39;73
2536;9;181009;11;6;19;10;35
2537;9;180509;6;15;6;15;36
2538;9;180808;9;20;11;59;90
2539;9;180415;7;16;14;5;35
2540;9;180609;8;16;6;17;39
2541;9;151406;11;14;18;11;43
2542;9;151508;7;13;6;26;45
2543;9;180116;5;8;14;51;73
2544;9;180315;7;8;18;29;55
2545;9;181010;11;12;6;45;63
2546;9;180416;7;8;17;49;74
2547;9;180117;5;8;7;8;23
2548;9;170911;8;19;15;10;44
2549;9;180610;8;13;8;57;78
2550;9;170912;8;17;14;51;82
2551;9;180711;4;16;20;50;86
2552;9;170913;8;5;12;21;38
2553;9;180809;9;10;13;18;41
2554;9;181011;11;20;6;10;36
2555;9;170914;8;20;20;19;59
2556;9;180214;5;17;12;15;44
2557;9;180316;7;16;15;58;89
2558;9;170915;8;6;18;23;47
2559;9;151309;6;9;15;44;68
2560;9;151407;11;18;19;35;72
2561;9;180510;6;10;7;57;74
2562;9;151509;7;8;13;7;28
2563;9;151310;6;14;14;40;68
2564;9;180215;5;9;11;52;72
2565;9;180611;8;20;19;8;47
2566;9;180712;4;13;15;13;41
2567;9;180810;9;7;13;8;28
2568;9;181012;11;17;6;32;55
2569;9;180417;7;15;5;35;55
2570;9;151408;11;12;19;31;62
2571;9;181013;11;13;10;14;37
2572;9;151510;7;19;11;40;70
2573;9;151311;6;20;10;45;75
2574;9;180811;9;14;7;55;76
2575;9;180511;6;11;12;30;53
2576;9;151409;11;18;20;12;50
2577;9;180612;8;13;10;20;43
2578;9;170916;8;18;10;23;51
2579;9;180713;4;7;15;17;39
2580;9;180812;9;17;5;38;60
2581;9;180118;5;9;12;48;69
2582;9;181014;11;15;9;16;40
2583;9;180418;7;6;5;9;20
2584;9;181015;11;17;19;39;75
2585;9;180613;8;18;6;31;55
2586;9;151410;11;5;13;43;61
2587;9;180714;4;17;19;53;89
2588;9;180813;9;14;12;31;57
2589;9;180317;7;18;19;35;72
2590;9;170917;8;6;11;38;55
2591;9;180512;6;7;6;20;33
2592;9;151312;6;11;19;48;78
2593;9;170918;8;13;17;9;39
2594;9;180216;5;6;12;55;73
2595;9;151411;11;11;13;39;63
2596;9;151511;7;20;7;54;81
2597;9;180419;7;17;16;40;73
2598;9;151512;7;5;15;29;49
2599;9;180614;8;9;20;7;36
2600;9;180715;4;5;9;42;56
2601;9;180513;6;10;11;38;59
2602;9;151313;6;7;18;18;43
2603;9;180615;8;10;20;53;83
2604;9;180716;4;13;10;54;77
2605;9;180814;9;13;15;42;70
2606;9;180318;7;11;15;49;75
2607;9;180616;8;18;7;13;38
2608;9;181016;11;20;5;35;60
2609;9;180119;5;7;19;42;68
2610;9;151412;11;9;20;10;39
2611;9;180420;7;17;13;32;62
2612;9;180319;7;19;9;7;35
2613;9;180717;4;14;9;35;58
2614;9;151413;11;12;5;23;40
2615;9;180815;9;8;8;14;30
2616;9;151513;7;6;8;60;74
2617;9;181017;11;15;14;53;82
2618;9;181018;11;8;13;60;81
2619;9;151514;7;5;9;33;47
2620;9;180120;5;14;12;17;43
2621;9;180617;8;20;19;35;74
2622;9;180718;4;14;14;51;79
2623;9;180816;9;17;6;11;34
2624;9;180514;6;9;5;17;31
2625;9;180421;7;8;13;44;65
2626;9;180618;8;13;16;57;86
2627;9;151515;7;8;18;59;85
2628;9;151314;6;10;11;33;54
2629;9;180217;5;15;15;53;83
2630;9;180320;7;19;5;51;75
2631;9;180121;5;13;6;32;51
2632;9;181019;11;17;9;31;57
2633;9;151414;11;13;10;8;31
2634;9;180122;5;8;13;42;63
2635;9;180218;5;5;5;24;34
2636;9;180515;6;9;5;27;41
2637;9;180321;7;5;16;53;74
2638;9;180219;5;6;13;23;42
2639;9;180422;7;5;16;51;72
2640;9;180719;4;16;5;22;43
2641;9;180817;9;14;5;34;53
2642;9;181020;11;18;18;31;67
2643;9;180220;5;6;5;30;41
2644;9;181021;11;19;5;45;69
2645;9;151415;11;7;5;55;67
2646;9;180322;7;8;19;35;62
2647;9;180516;6;17;10;25;52
2648;9;180619;8;12;10;50;72
2649;9;180720;4;11;18;12;41
2650;9;180818;9;7;8;27;42
2651;9;181022;11;6;15;18;39
2652;9;180819;9;10;12;55;77
2653;9;151315;6;18;19;37;74
2654;9;180517;6;18;12;8;38
2655;9;151416;11;12;5;15;32
2656;9;180518;6;14;17;60;91
2657;9;151516;7;9;10;5;24
2658;9;180423;7;18;14;16;48
2659;9;151316;6;20;7;20;47
2660;9;151417;11;10;8;48;66
2661;9;180221;5;16;10;20;46
2662;9;151517;7;16;5;50;71
2663;9;180323;7;15;18;45;78
2664;9;180820;9;19;11;52;82
2665;9;180222;5;15;5;11;31
2666;9;181023;11;19;7;55;81
2667;9;181024;11;15;8;17;40
2668;9;180821;9;13;5;31;49
2669;9;151317;6;15;9;38;62
2670;9;180519;6;20;6;24;50
2671;9;180123;5;12;18;11;41
2672;9;180620;8;9;17;36;62
2673;9;180424;7;19;12;49;80
2674;9;180223;5;15;12;28;55
2675;9;180721;4;6;16;20;42
2676;9;180324;7;6;17;38;61
2677;9;180520;6;8;14;26;48
2678;9;180822;9;14;12;51;77
2679;9;181025;11;12;17;13;42
2680;9;151418;11;13;8;7;28
2681;9;180224;5;5;12;44;61
2682;9;180722;4;20;16;35;71
2683;9;180425;7;15;13;24;52
2684;9;180521;6;16;14;53;83
2685;9;180621;8;17;15;53;85
2686;9;180124;5;9;12;34;55
2687;9;180325;7;7;20;28;55
2688;9;151419;11;7;13;59;79
2689;9;180723;4;6;15;9;30
2690;9;180823;9;20;7;35;62
2691;9;180125;5;12;6;10;28
2692;9;151518;7;10;10;16;36
2693;9;180522;6;20;13;51;84
2694;9;180622;8;12;19;16;47
2695;9;180523;6;12;16;27;55
2696;9;180225;5;11;18;14;43
2697;9;180524;6;7;14;36;57
2698;9;180126;5;12;9;55;76
2699;9;180326;7;15;6;37;58
2700;9;180724;4;5;15;32;52
2701;9;151318;6;6;8;7;21
2702;9;180127;5;11;15;55;81
2703;9;180426;7;8;10;49;67
2704;9;180824;9;18;6;15;39
2705;9;180825;9;6;19;25;50
2706;9;180525;6;15;11;7;33
2707;9;180526;6;6;18;42;66
2708;9;180623;8;18;6;42;66
2709;9;180624;8;14;16;59;89
2710;10;151301;3;19;8;39;66
2711;10;180101;9;12;8;10;30
2712;10;180501;1;18;19;13;50
2713;10;180701;10;20;19;22;61
2714;10;180201;4;5;19;39;63
2715;10;180301;6;7;19;24;50
2716;10;151501;8;9;15;55;79
2717;10;170901;10;12;11;26;49
2718;10;151302;3;6;8;15;29
2719;10;180801;8;8;7;59;74
2720;10;181001;3;12;6;44;62
2721;10;180102;9;10;9;58;77
2722;10;180401;8;12;8;29;49
2723;10;180502;1;15;18;43;76
2724;10;180202;4;20;9;9;38
2725;10;180302;6;7;8;15;30
2726;10;180601;4;5;14;33;52
2727;10;180303;6;10;16;34;60
2728;10;180402;8;15;12;30;57
2729;10;180702;10;8;5;33;46
2730;10;180103;9;12;7;59;78
2731;10;170902;10;6;8;12;26
2732;10;180203;4;20;19;60;99
2733;10;180802;8;6;17;5;28
2734;10;180503;1;12;7;43;62
2735;10;180304;6;19;7;6;32
2736;10;180403;8;9;7;57;73
2737;10;180602;4;12;15;20;47
2738;10;180703;10;16;18;28;62
2739;10;151401;1;12;17;27;56
2740;10;180104;9;16;12;38;66
2741;10;170903;10;18;18;16;52
2742;10;180105;9;9;12;17;38
2743;10;180204;4;16;16;26;58
2744;10;180305;6;6;10;33;49
2745;10;170904;10;8;7;55;70
2746;10;180404;8;17;6;27;50
2747;10;180106;9;20;15;42;77
2748;10;151303;3;14;5;29;48
2749;10;181002;3;6;12;8;26
2750;10;180704;10;16;7;12;35
2751;10;151402;1;18;5;34;57
2752;10;180504;1;14;18;45;77
2753;10;151304;3;18;9;13;40
2754;10;151502;8;16;20;27;63
2755;10;180705;10;20;11;35;66
2756;10;180603;4;5;18;6;29
2757;10;180803;8;19;11;12;42
2758;10;180306;6;13;14;51;78
2759;10;151503;8;17;14;18;49
2760;10;180205;4;5;6;7;18
2761;10;170905;10;15;11;42;68
2762;10;181003;3;15;6;59;80
2763;10;180405;8;9;18;43;70
2764;10;151305;3;10;12;14;36
2765;10;180307;6;5;11;17;33
2766;10;181004;3;13;17;37;67
2767;10;180406;8;20;12;46;78
2768;10;180505;1;11;12;32;55
2769;10;170906;10;19;14;59;92
2770;10;180604;4;7;20;54;81
2771;10;180308;6;5;8;33;46
2772;10;151403;1;20;15;41;76
2773;10;180206;4;9;12;44;65
2774;10;180407;8;13;7;48;68
2775;10;180706;10;20;20;20;60
2776;10;180107;9;14;11;41;66
2777;10;180804;8;16;7;29;52
2778;10;180207;4;8;17;32;57
2779;10;151504;8;7;19;14;40
2780;10;180408;8;13;8;18;39
2781;10;170907;10;17;9;52;78
2782;10;180108;9;17;7;20;44
2783;10;180309;6;18;11;50;79
2784;10;181005;3;9;14;42;65
2785;10;180605;4;19;15;36;70
2786;10;180109;9;8;9;49;66
2787;10;151306;3;20;19;59;98
2788;10;180707;10;8;15;43;66
2789;10;180110;9;6;8;46;60
2790;10;180409;8;6;19;31;56
2791;10;170908;10;16;13;53;82
2792;10;180506;1;13;20;8;41
2793;10;180606;4;16;10;9;35
2794;10;151404;1;18;10;12;40
2795;10;180805;8;18;9;25;52
2796;10;151505;8;9;11;10;30
2797;10;180410;8;15;11;35;61
2798;10;151307;3;10;15;7;32
2799;10;180310;6;8;7;16;31
2800;10;170909;10;12;7;18;37
2801;10;181006;3;20;8;49;77
2802;10;180111;9;16;13;17;46
2803;10;170910;10;16;12;55;83
2804;10;151506;8;19;7;23;49
2805;10;180311;6;11;5;8;24
2806;10;180112;9;17;17;34;68
2807;10;180708;10;16;6;14;36
2808;10;180507;1;13;9;18;40
2809;10;180607;4;6;18;26;50
2810;10;180709;10;16;9;38;63
2811;10;180806;8;8;16;47;71
2812;10;181007;3;12;15;27;54
2813;10;180411;8;17;5;47;69
2814;10;180208;4;18;11;50;79
2815;10;180312;6;9;15;45;69
2816;10;180412;8;11;11;55;77
2817;10;180113;9;12;18;52;82
2818;10;181008;3;16;7;11;34
2819;10;180508;1;12;8;48;68
2820;10;151308;3;19;20;34;73
2821;10;151405;1;19;7;51;77
2822;10;180608;4;9;6;55;70
2823;10;151507;8;13;11;18;42
2824;10;180209;4;12;6;18;36
2825;10;180313;6;5;19;36;60
2826;10;180413;8;16;9;22;47
2827;10;180114;9;7;9;38;54
2828;10;180210;4;13;13;29;55
2829;10;180710;10;19;13;31;63
2830;10;180807;8;19;20;53;92
2831;10;180211;4;16;5;56;77
2832;10;180115;9;5;18;13;36
2833;10;180212;4;12;16;6;34
2834;10;180414;8;16;17;21;54
2835;10;180314;6;7;13;20;40
2836;10;180213;4;20;13;24;57
2837;10;181009;3;11;19;9;39
2838;10;180509;1;12;13;14;39
2839;10;180808;8;5;5;19;29
2840;10;180415;8;5;17;27;49
2841;10;180609;4;20;14;28;62
2842;10;151406;1;16;17;30;63
2843;10;151508;8;16;8;22;46
2844;10;180116;9;17;18;53;88
2845;10;180315;6;8;13;27;48
2846;10;181010;3;14;10;13;37
2847;10;180416;8;19;10;40;69
2848;10;180117;9;9;12;58;79
2849;10;170911;10;7;20;38;65
2850;10;180610;4;11;18;38;67
2851;10;170912;10;7;5;59;71
2852;10;180711;10;17;6;10;33
2853;10;170913;10;9;18;41;68
2854;10;180809;8;9;15;45;69
2855;10;181011;3;6;17;26;49
2856;10;170914;10;15;15;33;63
2857;10;180214;4;11;11;31;53
2858;10;180316;6;16;16;6;38
2859;10;170915;10;5;16;56;77
2860;10;151309;3;10;11;39;60
2861;10;151407;1;10;8;10;28
2862;10;180510;1;11;18;46;75
2863;10;151509;8;12;7;13;32
2864;10;151310;3;20;13;50;83
2865;10;180215;4;19;12;22;53
2866;10;180611;4;11;20;19;50
2867;10;180712;10;20;8;57;85
2868;10;180810;8;14;5;18;37
2869;10;181012;3;10;19;10;39
2870;10;180417;8;15;14;39;68
2871;10;151408;1;9;9;19;37
2872;10;181013;3;16;13;52;81
2873;10;151510;8;20;9;8;37
2874;10;151311;3;20;18;39;77
2875;10;180811;8;20;7;58;85
2876;10;180511;1;6;14;14;34
2877;10;151409;1;12;5;28;45
2878;10;180612;4;12;7;50;69
2879;10;170916;10;8;17;29;54
2880;10;180713;10;13;8;51;72
2881;10;180812;8;16;14;13;43
2882;10;180118;9;13;16;53;82
2883;10;181014;3;12;16;46;74
2884;10;180418;8;18;9;15;42
2885;10;181015;3;15;16;17;48
2886;10;180613;4;20;6;59;85
2887;10;151410;1;6;18;58;82
2888;10;180714;10;20;11;31;62
2889;10;180813;8;11;11;23;45
2890;10;180317;6;19;16;48;83
2891;10;170917;10;12;5;26;43
2892;10;180512;1;7;19;25;51
2893;10;151312;3;13;8;36;57
2894;10;170918;10;15;19;18;52
2895;10;180216;4;10;6;17;33
2896;10;151411;1;10;16;39;65
2897;10;151511;8;17;16;48;81
2898;10;180419;8;12;17;29;58
2899;10;151512;8;18;18;43;79
2900;10;180614;4;19;12;53;84
2901;10;180715;10;12;14;58;84
2902;10;180513;1;13;16;46;75
2903;10;151313;3;10;19;51;80
2904;10;180615;4;20;11;34;65
2905;10;180716;10;11;8;38;57
2906;10;180814;8;7;19;48;74
2907;10;180318;6;18;13;53;84
2908;10;180616;4;17;12;14;43
2909;10;181016;3;13;7;28;48
2910;10;180119;9;17;14;38;69
2911;10;151412;1;20;11;52;83
2912;10;180420;8;17;5;20;42
2913;10;180319;6;15;8;18;41
2914;10;180717;10;15;11;53;79
2915;10;151413;1;19;19;52;90
2916;10;180815;8;8;13;42;63
2917;10;151513;8;20;5;53;78
2918;10;181017;3;9;5;21;35
2919;10;181018;3;20;5;36;61
2920;10;151514;8;13;17;8;38
2921;10;180120;9;5;5;45;55
2922;10;180617;4;19;17;14;50
2923;10;180718;10;16;11;29;56
2924;10;180816;8;19;17;31;67
2925;10;180514;1;20;18;6;44
2926;10;180421;8;10;14;9;33
2927;10;180618;4;17;6;5;28
2928;10;151515;8;7;12;32;51
2929;10;151314;3;15;18;13;46
2930;10;180217;4;5;8;30;43
2931;10;180320;6;19;5;17;41
2932;10;180121;9;20;15;52;87
2933;10;181019;3;12;15;55;82
2934;10;151414;1;13;6;39;58
2935;10;180122;9;15;8;22;45
2936;10;180218;4;10;16;36;62
2937;10;180515;1;16;20;38;74
2938;10;180321;6;11;17;17;45
2939;10;180219;4;19;8;22;49
2940;10;180422;8;12;6;56;74
2941;10;180719;10;8;8;52;68
2942;10;180817;8;5;6;44;55
2943;10;181020;3;17;5;6;28
2944;10;180220;4;17;5;45;67
2945;10;181021;3;17;18;18;53
2946;10;151415;1;9;18;44;71
2947;10;180322;6;11;7;32;50
2948;10;180516;1;15;7;16;38
2949;10;180619;4;16;19;14;49
2950;10;180720;10;7;15;58;80
2951;10;180818;8;10;10;42;62
2952;10;181022;3;10;17;23;50
2953;10;180819;8;19;16;30;65
2954;10;151315;3;19;13;31;63
2955;10;180517;1;14;16;51;81
2956;10;151416;1;20;15;38;73
2957;10;180518;1;13;16;19;48
2958;10;151516;8;9;17;45;71
2959;10;180423;8;12;6;56;74
2960;10;151316;3;5;13;23;41
2961;10;151417;1;12;15;58;85
2962;10;180221;4;11;16;11;38
2963;10;151517;8;7;6;12;25
2964;10;180323;6;19;6;7;32
2965;10;180820;8;7;6;7;20
2966;10;180222;4;15;19;26;60
2967;10;181023;3;17;19;8;44
2968;10;181024;3;19;11;8;38
2969;10;180821;8;10;6;19;35
2970;10;151317;3;8;14;32;54
2971;10;180519;1;6;6;37;49
2972;10;180123;9;20;17;9;46
2973;10;180620;4;10;13;47;70
2974;10;180424;8;8;18;27;53
2975;10;180223;4;10;17;23;50
2976;10;180721;10;19;7;9;35
2977;10;180324;6;5;6;33;44
2978;10;180520;1;8;13;37;58
2979;10;180822;8;7;14;15;36
2980;10;181025;3;7;5;20;32
2981;10;151418;1;16;7;16;39
2982;10;180224;4;10;20;43;73
2983;10;180722;10;12;5;59;76
2984;10;180425;8;19;6;18;43
2985;10;180521;1;11;16;32;59
2986;10;180621;4;13;13;58;84
2987;10;180124;9;18;12;25;55
2988;10;180325;6;13;15;7;35
2989;10;151419;1;15;14;20;49
2990;10;180723;10;15;20;39;74
2991;10;180823;8;19;10;31;60
2992;10;180125;9;10;15;10;35
2993;10;151518;8;12;17;26;55
2994;10;180522;1;19;6;36;61
2995;10;180622;4;7;18;6;31
2996;10;180523;1;13;20;7;40
2997;10;180225;4;14;20;40;74
2998;10;180524;1;17;9;27;53
2999;10;180126;9;13;6;30;49
3000;10;180326;6;18;9;40;67
3001;10;180724;10;12;5;47;64
3002;10;151318;3;7;20;55;82
3003;10;180127;9;13;12;14;39
3004;10;180426;8;12;5;51;68
3005;10;180824;8;18;6;21;45
3006;10;180825;8;14;8;12;34
3007;10;180525;1;13;19;13;45
3008;10;180526;1;12;9;60;81
3009;10;180623;4;18;6;18;42
3010;10;180624;4;9;5;58;72
3011;11;151301;9;13;12;53;78
3012;11;180101;9;8;7;60;75
3013;11;180501;4;13;10;57;80
3014;11;180701;5;17;20;49;86
3015;11;180201;11;18;16;21;55
3016;11;180301;3;16;9;57;82
3017;11;151501;5;8;18;16;42
3018;11;170901;9;5;20;58;83
3019;11;151302;9;16;12;25;53
3020;11;180801;3;19;12;50;81
3021;11;181001;8;11;9;13;33
3022;11;180102;9;11;11;41;63
3023;11;180401;1;5;13;12;30
3024;11;180502;4;20;11;48;79
3025;11;180202;11;13;18;39;70
3026;11;180302;3;10;14;19;43
3027;11;180601;11;16;7;28;51
3028;11;180303;3;6;19;13;38
3029;11;180402;1;11;14;36;61
3030;11;180702;5;16;7;53;76
3031;11;180103;9;6;13;20;39
3032;11;170902;9;11;20;29;60
3033;11;180203;11;14;5;45;64
3034;11;180802;3;17;18;14;49
3035;11;180503;4;15;14;11;40
3036;11;180304;3;10;10;19;39
3037;11;180403;1;9;5;30;44
3038;11;180602;11;20;20;37;77
3039;11;180703;5;10;13;17;40
3040;11;151401;2;14;12;59;85
3041;11;180104;9;17;17;35;69
3042;11;170903;9;8;5;29;42
3043;11;180105;9;13;14;23;50
3044;11;180204;11;14;14;32;60
3045;11;180305;3;9;8;12;29
3046;11;170904;9;12;15;54;81
3047;11;180404;1;10;20;56;86
3048;11;180106;9;20;9;41;70
3049;11;151303;9;13;14;31;58
3050;11;181002;8;11;7;37;55
3051;11;180704;5;9;15;34;58
3052;11;151402;2;11;6;42;59
3053;11;180504;4;5;7;6;18
3054;11;151304;9;8;18;52;78
3055;11;151502;5;5;20;41;66
3056;11;180705;5;10;5;58;73
3057;11;180603;11;15;9;36;60
3058;11;180803;3;8;12;31;51
3059;11;180306;3;8;17;43;68
3060;11;151503;5;17;13;49;79
3061;11;180205;11;8;19;25;52
3062;11;170905;9;19;15;30;64
3063;11;181003;8;7;9;21;37
3064;11;180405;1;15;6;11;32
3065;11;151305;9;14;8;10;32
3066;11;180307;3;14;12;43;69
3067;11;181004;8;11;9;15;35
3068;11;180406;1;19;11;32;62
3069;11;180505;4;19;14;27;60
3070;11;170906;9;18;9;10;37
3071;11;180604;11;17;6;38;61
3072;11;180308;3;12;8;44;64
3073;11;151403;2;6;19;51;76
3074;11;180206;11;14;18;8;40
3075;11;180407;1;6;17;48;71
3076;11;180706;5;11;7;28;46
3077;11;180107;9;9;12;11;32
3078;11;180804;3;8;15;13;36
3079;11;180207;11;5;6;24;35
3080;11;151504;5;19;16;9;44
3081;11;180408;1;14;20;58;92
3082;11;170907;9;8;11;9;28
3083;11;180108;9;19;9;13;41
3084;11;180309;3;6;8;6;20
3085;11;181005;8;9;13;29;51
3086;11;180605;11;6;9;30;45
3087;11;180109;9;14;7;48;69
3088;11;151306;9;14;20;44;78
3089;11;180707;5;15;12;54;81
3090;11;180110;9;14;6;54;74
3091;11;180409;1;16;10;52;78
3092;11;170908;9;8;20;41;69
3093;11;180506;4;18;10;19;47
3094;11;180606;11;15;5;42;62
3095;11;151404;2;6;13;39;58
3096;11;180805;3;18;13;51;82
3097;11;151505;5;6;7;23;36
3098;11;180410;1;20;20;8;48
3099;11;151307;9;12;12;27;51
3100;11;180310;3;14;7;26;47
3101;11;170909;9;13;19;35;67
3102;11;181006;8;16;12;23;51
3103;11;180111;9;18;9;11;38
3104;11;170910;9;16;17;39;72
3105;11;151506;5;14;19;17;50
3106;11;180311;3;15;7;34;56
3107;11;180112;9;8;18;12;38
3108;11;180708;5;17;10;14;41
3109;11;180507;4;11;12;58;81
3110;11;180607;11;6;16;36;58
3111;11;180709;5;14;12;36;62
3112;11;180806;3;8;15;49;72
3113;11;181007;8;16;8;29;53
3114;11;180411;1;15;7;34;56
3115;11;180208;11;20;11;17;48
3116;11;180312;3;12;10;55;77
3117;11;180412;1;8;18;19;45
3118;11;180113;9;8;13;48;69
3119;11;181008;8;6;11;20;37
3120;11;180508;4;12;9;16;37
3121;11;151308;9;15;6;41;62
3122;11;151405;2;13;10;34;57
3123;11;180608;11;19;13;36;68
3124;11;151507;5;20;8;53;81
3125;11;180209;11;14;17;5;36
3126;11;180313;3;15;7;50;72
3127;11;180413;1;13;8;41;62
3128;11;180114;9;6;9;60;75
3129;11;180210;11;5;10;9;24
3130;11;180710;5;14;13;45;72
3131;11;180807;3;6;20;33;59
3132;11;180211;11;20;6;5;31
3133;11;180115;9;20;10;35;65
3134;11;180212;11;14;19;31;64
3135;11;180414;1;10;9;28;47
3136;11;180314;3;5;16;10;31
3137;11;180213;11;9;9;46;64
3138;11;181009;8;14;12;12;38
3139;11;180509;4;19;6;11;36
3140;11;180808;3;20;12;12;44
3141;11;180415;1;19;19;43;81
3142;11;180609;11;10;6;54;70
3143;11;151406;2;9;9;49;67
3144;11;151508;5;9;19;33;61
3145;11;180116;9;9;14;16;39
3146;11;180315;3;12;15;36;63
3147;11;181010;8;5;16;53;74
3148;11;180416;1;9;20;48;77
3149;11;180117;9;18;8;18;44
3150;11;170911;9;19;6;19;44
3151;11;180610;11;11;15;8;34
3152;11;170912;9;20;6;21;47
3153;11;180711;5;7;8;19;34
3154;11;170913;9;10;6;21;37
3155;11;180809;3;17;11;30;58
3156;11;181011;8;16;19;12;47
3157;11;170914;9;14;16;13;43
3158;11;180214;11;13;19;10;42
3159;11;180316;3;16;16;23;55
3160;11;170915;9;12;5;33;50
3161;11;151309;9;18;12;54;84
3162;11;151407;2;13;18;47;78
3163;11;180510;4;18;16;16;50
3164;11;151509;5;6;15;13;34
3165;11;151310;9;8;8;9;25
3166;11;180215;11;16;16;36;68
3167;11;180611;11;9;11;9;29
3168;11;180712;5;13;14;25;52
3169;11;180810;3;17;17;16;50
3170;11;181012;8;17;14;6;37
3171;11;180417;1;11;8;36;55
3172;11;151408;2;14;16;51;81
3173;11;181013;8;5;14;48;67
3174;11;151510;5;11;17;35;63
3175;11;151311;9;9;6;58;73
3176;11;180811;3;6;19;39;64
3177;11;180511;4;12;17;19;48
3178;11;151409;2;18;19;17;54
3179;11;180612;11;17;15;42;74
3180;11;170916;9;17;18;11;46
3181;11;180713;5;15;8;33;56
3182;11;180812;3;8;11;59;78
3183;11;180118;9;7;9;10;26
3184;11;181014;8;14;15;5;34
3185;11;180418;1;19;16;11;46
3186;11;181015;8;13;18;43;74
3187;11;180613;11;5;13;43;61
3188;11;151410;2;18;10;36;64
3189;11;180714;5;5;12;41;58
3190;11;180813;3;14;9;49;72
3191;11;180317;3;11;6;54;71
3192;11;170917;9;13;6;13;32
3193;11;180512;4;9;6;31;46
3194;11;151312;9;19;6;45;70
3195;11;170918;9;7;18;31;56
3196;11;180216;11;19;15;15;49
3197;11;151411;2;11;14;31;56
3198;11;151511;5;19;17;56;92
3199;11;180419;1;10;9;44;63
3200;11;151512;5;6;19;34;59
3201;11;180614;11;9;15;42;66
3202;11;180715;5;13;5;36;54
3203;11;180513;4;16;18;35;69
3204;11;151313;9;16;7;35;58
3205;11;180615;11;20;15;56;91
3206;11;180716;5;10;19;37;66
3207;11;180814;3;18;9;21;48
3208;11;180318;3;11;10;22;43
3209;11;180616;11;15;6;53;74
3210;11;181016;8;14;14;34;62
3211;11;180119;9;17;6;37;60
3212;11;151412;2;10;14;57;81
3213;11;180420;1;20;16;20;56
3214;11;180319;3;10;14;35;59
3215;11;180717;5;9;11;43;63
3216;11;151413;2;18;11;33;62
3217;11;180815;3;12;10;31;53
3218;11;151513;5;13;8;59;80
3219;11;181017;8;6;7;11;24
3220;11;181018;8;7;10;42;59
3221;11;151514;5;10;8;29;47
3222;11;180120;9;18;14;21;53
3223;11;180617;11;16;12;35;63
3224;11;180718;5;20;11;28;59
3225;11;180816;3;6;19;34;59
3226;11;180514;4;16;15;6;37
3227;11;180421;1;6;14;52;72
3228;11;180618;11;18;8;56;82
3229;11;151515;5;6;18;15;39
3230;11;151314;9;12;9;35;56
3231;11;180217;11;15;8;7;30
3232;11;180320;3;11;15;59;85
3233;11;180121;9;15;11;38;64
3234;11;181019;8;14;18;41;73
3235;11;151414;2;16;16;17;49
3236;11;180122;9;13;14;47;74
3237;11;180218;11;6;10;40;56
3238;11;180515;4;5;11;51;67
3239;11;180321;3;15;11;6;32
3240;11;180219;11;13;7;20;40
3241;11;180422;1;8;12;33;53
3242;11;180719;5;7;19;53;79
3243;11;180817;3;11;17;25;53
3244;11;181020;8;5;13;54;72
3245;11;180220;11;15;11;56;82
3246;11;181021;8;11;12;9;32
3247;11;151415;2;16;19;19;54
3248;11;180322;3;11;16;11;38
3249;11;180516;4;13;5;28;46
3250;11;180619;11;14;6;33;53
3251;11;180720;5;14;5;54;73
3252;11;180818;3;18;7;13;38
3253;11;181022;8;15;17;58;90
3254;11;180819;3;7;16;34;57
3255;11;151315;9;16;6;30;52
3256;11;180517;4;9;16;14;39
3257;11;151416;2;16;12;25;53
3258;11;180518;4;13;17;46;76
3259;11;151516;5;10;9;57;76
3260;11;180423;1;6;18;19;43
3261;11;151316;9;20;6;11;37
3262;11;151417;2;6;11;18;35
3263;11;180221;11;16;8;59;83
3264;11;151517;5;10;6;44;60
3265;11;180323;3;16;6;59;81
3266;11;180820;3;19;13;30;62
3267;11;180222;11;18;6;12;36
3268;11;181023;8;16;10;7;33
3269;11;181024;8;16;14;59;89
3270;11;180821;3;11;15;17;43
3271;11;151317;9;20;19;19;58
3272;11;180519;4;6;11;43;60
3273;11;180123;9;11;14;34;59
3274;11;180620;11;17;20;38;75
3275;11;180424;1;10;11;39;60
3276;11;180223;11;7;13;20;40
3277;11;180721;5;14;6;36;56
3278;11;180324;3;18;14;48;80
3279;11;180520;4;11;6;29;46
3280;11;180822;3;18;14;15;47
3281;11;181025;8;15;11;17;43
3282;11;151418;2;17;19;14;50
3283;11;180224;11;19;18;49;86
3284;11;180722;5;12;19;9;40
3285;11;180425;1;5;15;35;55
3286;11;180521;4;20;9;56;85
3287;11;180621;11;18;6;32;56
3288;11;180124;9;16;7;50;73
3289;11;180325;3;15;17;54;86
3290;11;151419;2;6;13;18;37
3291;11;180723;5;5;20;38;63
3292;11;180823;3;14;9;38;61
3293;11;180125;9;12;8;23;43
3294;11;151518;5;5;13;53;71
3295;11;180522;4;7;12;16;35
3296;11;180622;11;5;19;5;29
3297;11;180523;4;13;20;13;46
3298;11;180225;11;14;15;15;44
3299;11;180524;4;15;5;25;45
3300;11;180126;9;7;19;11;37
3301;11;180326;3;14;15;14;43
3302;11;180724;5;16;18;38;72
3303;11;151318;9;12;16;17;45
3304;11;180127;9;5;19;27;51
3305;11;180426;1;8;9;31;48
3306;11;180824;3;17;17;23;57
3307;11;180825;3;13;11;39;63
3308;11;180525;4;6;13;34;53
3309;11;180526;4;12;14;49;75
3310;11;180623;11;9;14;53;76
3311;11;180624;11;10;5;27;42
3312;12;151301;1;8;5;27;40
3313;12;180101;4;11;10;56;77
3314;12;180501;9;9;11;5;25
3315;12;180701;11;19;9;27;55
3316;12;180201;4;6;18;41;65
3317;12;180301;9;14;11;39;64
3318;12;151501;9;9;19;53;81
3319;12;170901;5;20;9;12;41
3320;12;151302;1;13;18;53;84
3321;12;180801;6;14;8;6;28
3322;12;181001;3;11;10;31;52
3323;12;180102;4;12;8;47;67
3324;12;180401;10;10;5;27;42
3325;12;180502;9;13;12;16;41
3326;12;180202;4;6;9;14;29
3327;12;180302;9;7;12;6;25
3328;12;180601;6;20;18;20;58
3329;12;180303;9;18;6;60;84
3330;12;180402;10;6;7;54;67
3331;12;180702;11;17;5;45;67
3332;12;180103;4;7;17;59;83
3333;12;170902;5;13;20;56;89
3334;12;180203;4;15;18;53;86
3335;12;180802;6;15;7;19;41
3336;12;180503;9;17;14;8;39
3337;12;180304;9;18;12;6;36
3338;12;180403;10;5;5;28;38
3339;12;180602;6;18;11;31;60
3340;12;180703;11;9;5;52;66
3341;12;151401;8;5;8;10;23
3342;12;180104;4;6;13;23;42
3343;12;170903;5;19;7;18;44
3344;12;180105;4;19;15;31;65
3345;12;180204;4;7;6;18;31
3346;12;180305;9;11;5;21;37
3347;12;170904;5;14;9;18;41
3348;12;180404;10;17;20;52;89
3349;12;180106;4;14;20;53;87
3350;12;151303;1;7;16;16;39
3351;12;181002;3;10;20;51;81
3352;12;180704;11;9;18;50;77
3353;12;151402;8;19;7;48;74
3354;12;180504;9;13;13;23;49
3355;12;151304;1;9;12;54;75
3356;12;151502;9;19;6;34;59
3357;12;180705;11;14;5;58;77
3358;12;180603;6;6;9;14;29
3359;12;180803;6;12;12;51;75
3360;12;180306;9;20;10;25;55
3361;12;151503;9;11;11;28;50
3362;12;180205;4;15;13;18;46
3363;12;170905;5;7;15;20;42
3364;12;181003;3;5;12;45;62
3365;12;180405;10;12;8;59;79
3366;12;151305;1;16;10;23;49
3367;12;180307;9;5;19;20;44
3368;12;181004;3;11;9;31;51
3369;12;180406;10;19;5;56;80
3370;12;180505;9;18;12;54;84
3371;12;170906;5;13;20;10;43
3372;12;180604;6;7;17;29;53
3373;12;180308;9;14;12;39;65
3374;12;151403;8;10;8;30;48
3375;12;180206;4;18;17;37;72
3376;12;180407;10;14;5;52;71
3377;12;180706;11;11;15;8;34
3378;12;180107;4;10;14;32;56
3379;12;180804;6;8;15;48;71
3380;12;180207;4;15;9;6;30
3381;12;151504;9;10;8;12;30
3382;12;180408;10;10;9;53;72
3383;12;170907;5;18;15;12;45
3384;12;180108;4;13;12;33;58
3385;12;180309;9;19;10;6;35
3386;12;181005;3;16;9;28;53
3387;12;180605;6;20;8;12;40
3388;12;180109;4;7;14;51;72
3389;12;151306;1;8;10;35;53
3390;12;180707;11;12;17;29;58
3391;12;180110;4;17;20;25;62
3392;12;180409;10;8;10;38;56
3393;12;170908;5;20;11;46;77
3394;12;180506;9;11;15;45;71
3395;12;180606;6;15;11;18;44
3396;12;151404;8;16;12;27;55
3397;12;180805;6;13;11;38;62
3398;12;151505;9;13;9;7;29
3399;12;180410;10;17;20;10;47
3400;12;151307;1;20;16;39;75
3401;12;180310;9;20;12;10;42
3402;12;170909;5;16;8;38;62
3403;12;181006;3;19;6;33;58
3404;12;180111;4;11;18;9;38
3405;12;170910;5;13;6;16;35
3406;12;151506;9;11;14;49;74
3407;12;180311;9;15;13;34;62
3408;12;180112;4;18;11;53;82
3409;12;180708;11;19;18;19;56
3410;12;180507;9;9;12;41;62
3411;12;180607;6;5;15;17;37
3412;12;180709;11;16;13;54;83
3413;12;180806;6;9;18;12;39
3414;12;181007;3;12;9;48;69
3415;12;180411;10;15;18;38;71
3416;12;180208;4;6;7;12;25
3417;12;180312;9;5;12;23;40
3418;12;180412;10;6;8;46;60
3419;12;180113;4;19;12;12;43
3420;12;181008;3;10;14;38;62
3421;12;180508;9;16;10;41;67
3422;12;151308;1;13;5;5;23
3423;12;151405;8;8;13;20;41
3424;12;180608;6;11;19;42;72
3425;12;151507;9;9;15;55;79
3426;12;180209;4;16;11;26;53
3427;12;180313;9;10;15;25;50
3428;12;180413;10;14;13;59;86
3429;12;180114;4;13;14;43;70
3430;12;180210;4;13;15;5;33
3431;12;180710;11;17;11;31;59
3432;12;180807;6;10;5;22;37
3433;12;180211;4;16;10;46;72
3434;12;180115;4;14;10;52;76
3435;12;180212;4;10;10;57;77
3436;12;180414;10;16;10;56;82
3437;12;180314;9;16;7;16;39
3438;12;180213;4;13;15;23;51
3439;12;181009;3;7;13;25;45
3440;12;180509;9;16;20;28;64
3441;12;180808;6;7;14;49;70
3442;12;180415;10;19;14;23;56
3443;12;180609;6;11;16;7;34
3444;12;151406;8;6;9;41;56
3445;12;151508;9;5;13;23;41
3446;12;180116;4;20;11;27;58
3447;12;180315;9;19;15;5;39
3448;12;181010;3;9;9;53;71
3449;12;180416;10;13;9;28;50
3450;12;180117;4;13;12;17;42
3451;12;170911;5;9;11;27;47
3452;12;180610;6;12;8;50;70
3453;12;170912;5;9;13;53;75
3454;12;180711;11;10;11;24;45
3455;12;170913;5;10;17;9;36
3456;12;180809;6;11;5;19;35
3457;12;181011;3;20;12;25;57
3458;12;170914;5;9;16;26;51
3459;12;180214;4;10;12;52;74
3460;12;180316;9;8;12;9;29
3461;12;170915;5;10;11;27;48
3462;12;151309;1;8;14;10;32
3463;12;151407;8;14;14;23;51
3464;12;180510;9;20;18;38;76
3465;12;151509;9;9;18;43;70
3466;12;151310;1;19;6;6;31
3467;12;180215;4;16;5;12;33
3468;12;180611;6;5;16;35;56
3469;12;180712;11;8;13;40;61
3470;12;180810;6;15;6;49;70
3471;12;181012;3;7;17;16;40
3472;12;180417;10;7;13;60;80
3473;12;151408;8;13;16;32;61
3474;12;181013;3;9;9;18;36
3475;12;151510;9;12;8;45;65
3476;12;151311;1;14;17;47;78
3477;12;180811;6;18;6;32;56
3478;12;180511;9;12;10;17;39
3479;12;151409;8;17;14;23;54
3480;12;180612;6;7;18;35;60
3481;12;170916;5;14;19;19;52
3482;12;180713;11;13;20;5;38
3483;12;180812;6;9;15;53;77
3484;12;180118;4;16;18;13;47
3485;12;181014;3;11;5;42;58
3486;12;180418;10;10;13;40;63
3487;12;181015;3;18;18;29;65
3488;12;180613;6;17;8;23;48
3489;12;151410;8;10;11;45;66
3490;12;180714;11;18;13;51;82
3491;12;180813;6;7;12;58;77
3492;12;180317;9;20;19;29;68
3493;12;170917;5;5;17;30;52
3494;12;180512;9;16;6;59;81
3495;12;151312;1;6;6;55;67
3496;12;170918;5;14;12;25;51
3497;12;180216;4;13;6;52;71
3498;12;151411;8;18;13;53;84
3499;12;151511;9;19;11;54;84
3500;12;180419;10;8;16;59;83
3501;12;151512;9;10;15;27;52
3502;12;180614;6;13;13;15;41
3503;12;180715;11;5;11;54;70
3504;12;180513;9;18;13;50;81
3505;12;151313;1;9;5;29;43
3506;12;180615;6;11;14;35;60
3507;12;180716;11;5;6;9;20
3508;12;180814;6;14;20;55;89
3509;12;180318;9;13;10;56;79
3510;12;180616;6;11;18;56;85
3511;12;181016;3;8;19;47;74
3512;12;180119;4;20;5;37;62
3513;12;151412;8;5;17;47;69
3514;12;180420;10;13;7;37;57
3515;12;180319;9;12;15;35;62
3516;12;180717;11;12;20;58;90
3517;12;151413;8;8;8;43;59
3518;12;180815;6;6;11;60;77
3519;12;151513;9;17;17;22;56
3520;12;181017;3;16;10;50;76
3521;12;181018;3;11;16;44;71
3522;12;151514;9;13;16;33;62
3523;12;180120;4;14;17;41;72
3524;12;180617;6;19;6;13;38
3525;12;180718;11;10;17;8;35
3526;12;180816;6;13;5;45;63
3527;12;180514;9;17;16;34;67
3528;12;180421;10;14;9;6;29
3529;12;180618;6;11;12;19;42
3530;12;151515;9;13;8;57;78
3531;12;151314;1;20;14;60;94
3532;12;180217;4;17;13;55;85
3533;12;180320;9;16;16;42;74
3534;12;180121;4;13;7;24;44
3535;12;181019;3;6;17;35;58
3536;12;151414;8;20;11;54;85
3537;12;180122;4;18;18;24;60
3538;12;180218;4;13;13;22;48
3539;12;180515;9;20;8;22;50
3540;12;180321;9;6;6;50;62
3541;12;180219;4;14;6;38;58
3542;12;180422;10;16;12;30;58
3543;12;180719;11;7;14;27;48
3544;12;180817;6;11;9;43;63
3545;12;181020;3;20;18;10;48
3546;12;180220;4;19;13;7;39
3547;12;181021;3;8;9;20;37
3548;12;151415;8;11;20;39;70
3549;12;180322;9;17;15;9;41
3550;12;180516;9;19;12;59;90
3551;12;180619;6;14;16;12;42
3552;12;180720;11;9;12;46;67
3553;12;180818;6;7;9;29;45
3554;12;181022;3;15;18;57;90
3555;12;180819;6;15;14;59;88
3556;12;151315;1;8;10;17;35
3557;12;180517;9;15;18;19;52
3558;12;151416;8;8;6;15;29
3559;12;180518;9;18;19;32;69
3560;12;151516;9;5;7;56;68
3561;12;180423;10;10;13;34;57
3562;12;151316;1;16;15;27;58
3563;12;151417;8;7;20;34;61
3564;12;180221;4;8;7;51;66
3565;12;151517;9;10;14;49;73
3566;12;180323;9;16;20;54;90
3567;12;180820;6;11;7;47;65
3568;12;180222;4;5;18;22;45
3569;12;181023;3;16;12;52;80
3570;12;181024;3;19;7;54;80
3571;12;180821;6;11;12;18;41
3572;12;151317;1;7;17;51;75
3573;12;180519;9;13;15;58;86
3574;12;180123;4;15;20;45;80
3575;12;180620;6;16;11;50;77
3576;12;180424;10;8;7;56;71
3577;12;180223;4;13;14;30;57
3578;12;180721;11;8;13;34;55
3579;12;180324;9;16;8;55;79
3580;12;180520;9;17;17;36;70
3581;12;180822;6;6;20;16;42
3582;12;181025;3;16;12;17;45
3583;12;151418;8;6;9;46;61
3584;12;180224;4;6;7;8;21
3585;12;180722;11;19;10;27;56
3586;12;180425;10;16;9;25;50
3587;12;180521;9;5;6;5;16
3588;12;180621;6;6;12;43;61
3589;12;180124;4;8;10;37;55
3590;12;180325;9;18;6;56;80
3591;12;151419;8;13;7;50;70
3592;12;180723;11;7;20;50;77
3593;12;180823;6;15;13;12;40
3594;12;180125;4;13;16;59;88
3595;12;151518;9;8;10;47;65
3596;12;180522;9;20;14;6;40
3597;12;180622;6;17;13;6;36
3598;12;180523;9;17;9;46;72
3599;12;180225;4;8;19;60;87
3600;12;180524;9;8;20;10;38
3601;12;180126;4;20;6;56;82
3602;12;180326;9;12;13;48;73
3603;12;180724;11;5;11;49;65
3604;12;151318;1;9;5;16;30
3605;12;180127;4;14;14;12;40
3606;12;180426;10;14;14;40;68
3607;12;180824;6;17;11;7;35
3608;12;180825;6;8;10;45;63
3609;12;180525;9;17;12;59;88
3610;12;180526;9;19;13;27;59
3611;12;180623;6;18;13;23;54
3612;12;180624;6;9;6;10;25
3613;13;151301;1;11;16;41;68
3614;13;180101;9;19;12;59;90
3615;13;180501;4;9;16;23;48
3616;13;180701;7;17;18;9;44
3617;13;180201;1;11;15;59;85
3618;13;180301;2;18;17;54;89
3619;13;151501;6;9;14;34;57
3620;13;170901;5;5;10;6;21
3621;13;151302;1;19;5;20;44
3622;13;180801;8;11;20;12;43
3623;13;181001;11;11;16;41;68
3624;13;180102;9;8;5;53;66
3625;13;180401;6;6;6;60;72
3626;13;180502;4;11;15;21;47
3627;13;180202;1;9;18;43;70
3628;13;180302;2;8;12;19;39
3629;13;180601;3;5;14;53;72
3630;13;180303;2;14;17;14;45
3631;13;180402;6;11;9;13;33
3632;13;180702;7;9;14;8;31
3633;13;180103;9;9;11;47;67
3634;13;170902;5;5;15;60;80
3635;13;180203;1;18;8;57;83
3636;13;180802;8;13;7;15;35
3637;13;180503;4;17;5;34;56
3638;13;180304;2;19;10;41;70
3639;13;180403;6;13;18;17;48
3640;13;180602;3;6;20;17;43
3641;13;180703;7;15;6;49;70
3642;13;151401;10;11;15;5;31
3643;13;180104;9;19;9;33;61
3644;13;170903;5;5;17;24;46
3645;13;180105;9;17;7;12;36
3646;13;180204;1;10;13;16;39
3647;13;180305;2;15;16;29;60
3648;13;170904;5;13;18;29;60
3649;13;180404;6;6;8;12;26
3650;13;180106;9;9;5;47;61
3651;13;151303;1;16;8;49;73
3652;13;181002;11;5;15;22;42
3653;13;180704;7;7;11;45;63
3654;13;151402;10;7;12;16;35
3655;13;180504;4;5;12;34;51
3656;13;151304;1;17;5;36;58
3657;13;151502;6;6;7;32;45
3658;13;180705;7;18;10;34;62
3659;13;180603;3;12;18;40;70
3660;13;180803;8;13;5;60;78
3661;13;180306;2;19;15;37;71
3662;13;151503;6;11;13;56;80
3663;13;180205;1;9;14;38;61
3664;13;170905;5;6;17;39;62
3665;13;181003;11;10;13;34;57
3666;13;180405;6;5;12;51;68
3667;13;151305;1;18;20;38;76
3668;13;180307;2;17;5;8;30
3669;13;181004;11;10;13;10;33
3670;13;180406;6;5;7;58;70
3671;13;180505;4;5;9;39;53
3672;13;170906;5;16;16;31;63
3673;13;180604;3;15;18;48;81
3674;13;180308;2;7;11;53;71
3675;13;151403;10;15;6;30;51
3676;13;180206;1;7;7;59;73
3677;13;180407;6;11;20;26;57
3678;13;180706;7;7;11;46;64
3679;13;180107;9;15;19;26;60
3680;13;180804;8;14;11;13;38
3681;13;180207;1;18;12;38;68
3682;13;151504;6;13;14;27;54
3683;13;180408;6;9;11;45;65
3684;13;170907;5;17;10;44;71
3685;13;180108;9;17;10;21;48
3686;13;180309;2;20;17;35;72
3687;13;181005;11;18;14;25;57
3688;13;180605;3;20;15;57;92
3689;13;180109;9;8;6;60;74
3690;13;151306;1;9;16;41;66
3691;13;180707;7;6;6;30;42
3692;13;180110;9;10;10;44;64
3693;13;180409;6;15;11;39;65
3694;13;170908;5;5;6;46;57
3695;13;180506;4;16;10;59;85
3696;13;180606;3;8;20;20;48
3697;13;151404;10;17;10;44;71
3698;13;180805;8;14;18;42;74
3699;13;151505;6;12;11;27;50
3700;13;180410;6;12;17;45;74
3701;13;151307;1;11;16;47;74
3702;13;180310;2;9;7;57;73
3703;13;170909;5;16;5;42;63
3704;13;181006;11;17;9;22;48
3705;13;180111;9;5;11;13;29
3706;13;170910;5;17;17;30;64
3707;13;151506;6;12;19;53;84
3708;13;180311;2;13;18;23;54
3709;13;180112;9;20;12;28;60
3710;13;180708;7;13;17;45;75
3711;13;180507;4;17;9;16;42
3712;13;180607;3;5;17;46;68
3713;13;180709;7;20;14;58;92
3714;13;180806;8;18;13;60;91
3715;13;181007;11;18;6;27;51
3716;13;180411;6;14;10;7;31
3717;13;180208;1;15;11;35;61
3718;13;180312;2;11;19;30;60
3719;13;180412;6;17;14;13;44
3720;13;180113;9;18;8;24;50
3721;13;181008;11;15;11;46;72
3722;13;180508;4;7;17;17;41
3723;13;151308;1;19;17;21;57
3724;13;151405;10;16;13;43;72
3725;13;180608;3;5;14;14;33
3726;13;151507;6;16;10;8;34
3727;13;180209;1;15;20;38;73
3728;13;180313;2;11;10;13;34
3729;13;180413;6;15;16;20;51
3730;13;180114;9;15;11;29;55
3731;13;180210;1;8;6;54;68
3732;13;180710;7;9;10;17;36
3733;13;180807;8;9;19;10;38
3734;13;180211;1;13;17;60;90
3735;13;180115;9;18;9;5;32
3736;13;180212;1;6;17;46;69
3737;13;180414;6;13;19;16;48
3738;13;180314;2;20;10;21;51
3739;13;180213;1;6;13;39;58
3740;13;181009;11;6;19;14;39
3741;13;180509;4;17;8;47;72
3742;13;180808;8;17;7;60;84
3743;13;180415;6;14;12;21;47
3744;13;180609;3;7;5;50;62
3745;13;151406;10;6;7;8;21
3746;13;151508;6;20;18;33;71
3747;13;180116;9;7;17;20;44
3748;13;180315;2;8;9;49;66
3749;13;181010;11;10;19;16;45
3750;13;180416;6;16;7;55;78
3751;13;180117;9;11;6;21;38
3752;13;170911;5;7;13;44;64
3753;13;180610;3;18;12;47;77
3754;13;170912;5;5;16;31;52
3755;13;180711;7;6;20;12;38
3756;13;170913;5;18;20;28;66
3757;13;180809;8;10;11;26;47
3758;13;181011;11;20;16;5;41
3759;13;170914;5;12;16;5;33
3760;13;180214;1;14;12;36;62
3761;13;180316;2;18;9;17;44
3762;13;170915;5;12;8;60;80
3763;13;151309;1;10;20;51;81
3764;13;151407;10;15;5;8;28
3765;13;180510;4;18;15;52;85
3766;13;151509;6;6;17;22;45
3767;13;151310;1;17;16;18;51
3768;13;180215;1;17;20;34;71
3769;13;180611;3;13;14;11;38
3770;13;180712;7;9;18;50;77
3771;13;180810;8;7;12;5;24
3772;13;181012;11;12;13;41;66
3773;13;180417;6;7;6;12;25
3774;13;151408;10;15;14;56;85
3775;13;181013;11;7;13;30;50
3776;13;151510;6;5;13;34;52
3777;13;151311;1;10;13;59;82
3778;13;180811;8;15;11;36;62
3779;13;180511;4;9;11;7;27
3780;13;151409;10;15;17;19;51
3781;13;180612;3;8;13;11;32
3782;13;170916;5;10;11;11;32
3783;13;180713;7;18;12;56;86
3784;13;180812;8;12;13;22;47
3785;13;180118;9;14;14;49;77
3786;13;181014;11;17;16;33;66
3787;13;180418;6;18;15;59;92
3788;13;181015;11;17;13;10;40
3789;13;180613;3;8;11;13;32
3790;13;151410;10;19;6;21;46
3791;13;180714;7;10;11;9;30
3792;13;180813;8;16;17;25;58
3793;13;180317;2;14;10;40;64
3794;13;170917;5;7;15;24;46
3795;13;180512;4;18;8;36;62
3796;13;151312;1;15;9;50;74
3797;13;170918;5;15;19;50;84
3798;13;180216;1;9;9;53;71
3799;13;151411;10;12;13;55;80
3800;13;151511;6;5;7;40;52
3801;13;180419;6;9;15;48;72
3802;13;151512;6;17;5;27;49
3803;13;180614;3;17;7;5;29
3804;13;180715;7;19;10;18;47
3805;13;180513;4;11;5;37;53
3806;13;151313;1;20;7;40;67
3807;13;180615;3;19;12;11;42
3808;13;180716;7;13;6;49;68
3809;13;180814;8;8;6;9;23
3810;13;180318;2;9;6;51;66
3811;13;180616;3;19;8;58;85
3812;13;181016;11;7;15;16;38
3813;13;180119;9;16;5;47;68
3814;13;151412;10;8;5;33;46
3815;13;180420;6;20;11;33;64
3816;13;180319;2;9;7;5;21
3817;13;180717;7;8;5;29;42
3818;13;151413;10;20;12;53;85
3819;13;180815;8;5;6;44;55
3820;13;151513;6;19;9;19;47
3821;13;181017;11;20;17;26;63
3822;13;181018;11;10;8;11;29
3823;13;151514;6;19;11;32;62
3824;13;180120;9;6;16;56;78
3825;13;180617;3;13;13;31;57
3826;13;180718;7;16;7;33;56
3827;13;180816;8;17;16;45;78
3828;13;180514;4;8;16;20;44
3829;13;180421;6;12;11;54;77
3830;13;180618;3;12;18;22;52
3831;13;151515;6;5;9;16;30
3832;13;151314;1;17;12;46;75
3833;13;180217;1;5;6;15;26
3834;13;180320;2;5;17;17;39
3835;13;180121;9;11;8;10;29
3836;13;181019;11;9;14;8;31
3837;13;151414;10;13;11;31;55
3838;13;180122;9;13;14;14;41
3839;13;180218;1;6;14;25;45
3840;13;180515;4;11;13;5;29
3841;13;180321;2;20;5;8;33
3842;13;180219;1;16;10;40;66
3843;13;180422;6;6;10;33;49
3844;13;180719;7;11;17;46;74
3845;13;180817;8;6;5;19;30
3846;13;181020;11;20;17;60;97
3847;13;180220;1;12;14;48;74
3848;13;181021;11;16;10;40;66
3849;13;151415;10;19;11;13;43
3850;13;180322;2;15;16;5;36
3851;13;180516;4;12;9;13;34
3852;13;180619;3;17;12;14;43
3853;13;180720;7;13;16;43;72
3854;13;180818;8;7;5;60;72
3855;13;181022;11;12;14;31;57
3856;13;180819;8;20;15;5;40
3857;13;151315;1;12;10;12;34
3858;13;180517;4;20;20;42;82
3859;13;151416;10;11;6;57;74
3860;13;180518;4;6;6;16;28
3861;13;151516;6;20;13;17;50
3862;13;180423;6;15;17;39;71
3863;13;151316;1;10;8;17;35
3864;13;151417;10;13;7;54;74
3865;13;180221;1;17;20;53;90
3866;13;151517;6;9;14;24;47
3867;13;180323;2;18;9;52;79
3868;13;180820;8;10;11;55;76
3869;13;180222;1;7;7;28;42
3870;13;181023;11;16;6;32;54
3871;13;181024;11;13;13;54;80
3872;13;180821;8;7;19;41;67
3873;13;151317;1;5;10;17;32
3874;13;180519;4;15;18;9;42
3875;13;180123;9;19;20;23;62
3876;13;180620;3;16;7;46;69
3877;13;180424;6;11;12;27;50
3878;13;180223;1;12;20;10;42
3879;13;180721;7;15;12;28;55
3880;13;180324;2;16;10;45;71
3881;13;180520;4;13;16;55;84
3882;13;180822;8;12;7;14;33
3883;13;181025;11;15;15;30;60
3884;13;151418;10;17;11;46;74
3885;13;180224;1;20;10;19;49
3886;13;180722;7;6;17;13;36
3887;13;180425;6;17;12;16;45
3888;13;180521;4;13;11;55;79
3889;13;180621;3;8;15;45;68
3890;13;180124;9;12;9;57;78
3891;13;180325;2;7;10;5;22
3892;13;151419;10;12;9;59;80
3893;13;180723;7;7;16;26;49
3894;13;180823;8;17;12;13;42
3895;13;180125;9;15;18;52;85
3896;13;151518;6;12;20;10;42
3897;13;180522;4;20;8;8;36
3898;13;180622;3;6;5;10;21
3899;13;180523;4;9;6;18;33
3900;13;180225;1;5;5;37;47
3901;13;180524;4;13;7;14;34
3902;13;180126;9;7;5;35;47
3903;13;180326;2;19;6;56;81
3904;13;180724;7;15;5;37;57
3905;13;151318;1;16;13;49;78
3906;13;180127;9;8;20;38;66
3907;13;180426;6;17;13;17;47
3908;13;180824;8;8;6;29;43
3909;13;180825;8;19;19;46;84
3910;13;180525;4;10;13;25;48
3911;13;180526;4;16;16;17;49
3912;13;180623;3;15;19;60;94
3913;13;180624;3;17;17;47;81
3914;14;151301;7;17;9;36;62
3915;14;180101;1;18;8;37;63
3916;14;180501;10;5;14;33;52
3917;14;180701;1;5;16;10;31
3918;14;180201;3;9;15;31;55
3919;14;180301;8;14;15;18;47
3920;14;151501;7;5;17;44;66
3921;14;170901;10;9;6;28;43
3922;14;151302;7;20;10;41;71
3923;14;180801;4;20;20;60;100
3924;14;181001;8;20;15;55;90
3925;14;180102;1;9;15;21;45
3926;14;180401;6;10;10;60;80
3927;14;180502;10;7;16;55;78
3928;14;180202;3;13;11;13;37
3929;14;180302;8;9;18;31;58
3930;14;180601;9;13;13;18;44
3931;14;180303;8;15;20;34;69
3932;14;180402;6;7;8;29;44
3933;14;180702;1;8;6;37;51
3934;14;180103;1;18;15;59;92
3935;14;170902;10;6;9;23;38
3936;14;180203;3;6;14;35;55
3937;14;180802;4;20;5;57;82
3938;14;180503;10;19;20;26;65
3939;14;180304;8;14;8;52;74
3940;14;180403;6;20;14;41;75
3941;14;180602;9;16;14;47;77
3942;14;180703;1;5;8;32;45
3943;14;151401;2;7;16;43;66
3944;14;180104;1;12;12;10;34
3945;14;170903;10;15;17;42;74
3946;14;180105;1;17;20;36;73
3947;14;180204;3;11;20;21;52
3948;14;180305;8;10;19;49;78
3949;14;170904;10;11;8;52;71
3950;14;180404;6;16;12;27;55
3951;14;180106;1;10;19;40;69
3952;14;151303;7;19;13;53;85
3953;14;181002;8;7;10;17;34
3954;14;180704;1;14;14;52;80
3955;14;151402;2;12;17;20;49
3956;14;180504;10;15;15;19;49
3957;14;151304;7;15;20;10;45
3958;14;151502;7;10;5;11;26
3959;14;180705;1;9;14;59;82
3960;14;180603;9;8;14;55;77
3961;14;180803;4;20;20;22;62
3962;14;180306;8;17;10;18;45
3963;14;151503;7;8;14;16;38
3964;14;180205;3;19;19;19;57
3965;14;170905;10;5;9;10;24
3966;14;181003;8;8;17;53;78
3967;14;180405;6;8;7;57;72
3968;14;151305;7;8;12;53;73
3969;14;180307;8;17;14;41;72
3970;14;181004;8;20;8;47;75
3971;14;180406;6;7;12;53;72
3972;14;180505;10;18;8;21;47
3973;14;170906;10;16;6;19;41
3974;14;180604;9;19;10;48;77
3975;14;180308;8;8;14;16;38
3976;14;151403;2;10;10;54;74
3977;14;180206;3;9;11;45;65
3978;14;180407;6;8;7;22;37
3979;14;180706;1;14;13;14;41
3980;14;180107;1;20;17;18;55
3981;14;180804;4;14;16;60;90
3982;14;180207;3;14;11;49;74
3983;14;151504;7;13;15;15;43
3984;14;180408;6;12;7;55;74
3985;14;170907;10;9;12;8;29
3986;14;180108;1;20;14;33;67
3987;14;180309;8;16;12;44;72
3988;14;181005;8;9;16;49;74
3989;14;180605;9;15;16;59;90
3990;14;180109;1;20;12;41;73
3991;14;151306;7;19;9;35;63
3992;14;180707;1;15;7;58;80
3993;14;180110;1;15;7;53;75
3994;14;180409;6;11;10;10;31
3995;14;170908;10;6;16;47;69
3996;14;180506;10;20;9;16;45
3997;14;180606;9;10;9;6;25
3998;14;151404;2;12;19;18;49
3999;14;180805;4;10;11;54;75
4000;14;151505;7;12;19;5;36
4001;14;180410;6;10;17;9;36
4002;14;151307;7;18;16;58;92
4003;14;180310;8;6;19;42;67
4004;14;170909;10;6;11;41;58
4005;14;181006;8;15;7;20;42
4006;14;180111;1;18;8;44;70
4007;14;170910;10;5;15;47;67
4008;14;151506;7;9;15;51;75
4009;14;180311;8;12;15;42;69
4010;14;180112;1;14;17;43;74
4011;14;180708;1;18;14;20;52
4012;14;180507;10;9;13;54;76
4013;14;180607;9;13;5;39;57
4014;14;180709;1;11;10;40;61
4015;14;180806;4;11;18;40;69
4016;14;181007;8;20;9;36;65
4017;14;180411;6;19;10;34;63
4018;14;180208;3;8;7;43;58
4019;14;180312;8;16;7;16;39
4020;14;180412;6;15;8;26;49
4021;14;180113;1;15;9;36;60
4022;14;181008;8;16;13;5;34
4023;14;180508;10;17;11;37;65
4024;14;151308;7;6;15;29;50
4025;14;151405;2;14;6;22;42
4026;14;180608;9;17;17;34;68
4027;14;151507;7;18;13;9;40
4028;14;180209;3;15;12;50;77
4029;14;180313;8;5;6;54;65
4030;14;180413;6;11;13;46;70
4031;14;180114;1;5;7;24;36
4032;14;180210;3;10;10;27;47
4033;14;180710;1;20;12;10;42
4034;14;180807;4;11;8;50;69
4035;14;180211;3;19;17;5;41
4036;14;180115;1;7;11;11;29
4037;14;180212;3;8;13;23;44
4038;14;180414;6;19;14;56;89
4039;14;180314;8;17;15;49;81
4040;14;180213;3;18;12;48;78
4041;14;181009;8;17;14;52;83
4042;14;180509;10;8;17;6;31
4043;14;180808;4;9;14;38;61
4044;14;180415;6;15;17;13;45
4045;14;180609;9;5;10;53;68
4046;14;151406;2;19;14;6;39
4047;14;151508;7;11;11;7;29
4048;14;180116;1;18;10;60;88
4049;14;180315;8;13;9;9;31
4050;14;181010;8;10;19;26;55
4051;14;180416;6;10;17;45;72
4052;14;180117;1;15;11;7;33
4053;14;170911;10;20;5;11;36
4054;14;180610;9;17;18;18;53
4055;14;170912;10;13;15;42;70
4056;14;180711;1;20;8;27;55
4057;14;170913;10;12;19;47;78
4058;14;180809;4;17;12;45;74
4059;14;181011;8;14;17;41;72
4060;14;170914;10;16;12;42;70
4061;14;180214;3;20;11;42;73
4062;14;180316;8;6;6;48;60
4063;14;170915;10;16;15;8;39
4064;14;151309;7;7;9;39;55
4065;14;151407;2;18;11;60;89
4066;14;180510;10;15;8;24;47
4067;14;151509;7;10;20;7;37
4068;14;151310;7;9;20;16;45
4069;14;180215;3;19;18;35;72
4070;14;180611;9;13;9;24;46
4071;14;180712;1;15;5;60;80
4072;14;180810;4;19;13;50;82
4073;14;181012;8;11;15;14;40
4074;14;180417;6;18;14;6;38
4075;14;151408;2;12;11;40;63
4076;14;181013;8;14;11;10;35
4077;14;151510;7;11;17;15;43
4078;14;151311;7;18;13;30;61
4079;14;180811;4;11;5;17;33
4080;14;180511;10;19;20;16;55
4081;14;151409;2;19;9;48;76
4082;14;180612;9;10;17;41;68
4083;14;170916;10;8;6;53;67
4084;14;180713;1;6;17;45;68
4085;14;180812;4;17;16;5;38
4086;14;180118;1;19;17;33;69
4087;14;181014;8;19;6;40;65
4088;14;180418;6;9;15;54;78
4089;14;181015;8;16;17;16;49
4090;14;180613;9;7;12;27;46
4091;14;151410;2;16;17;9;42
4092;14;180714;1;13;7;47;67
4093;14;180813;4;15;11;22;48
4094;14;180317;8;15;7;12;34
4095;14;170917;10;20;16;49;85
4096;14;180512;10;11;10;50;71
4097;14;151312;7;13;7;54;74
4098;14;170918;10;7;5;44;56
4099;14;180216;3;15;8;10;33
4100;14;151411;2;6;15;34;55
4101;14;151511;7;14;15;41;70
4102;14;180419;6;17;19;13;49
4103;14;151512;7;17;20;38;75
4104;14;180614;9;19;20;32;71
4105;14;180715;1;13;10;50;73
4106;14;180513;10;7;13;23;43
4107;14;151313;7;15;10;21;46
4108;14;180615;9;18;17;9;44
4109;14;180716;1;8;10;5;23
4110;14;180814;4;6;17;41;64
4111;14;180318;8;10;7;44;61
4112;14;180616;9;15;6;49;70
4113;14;181016;8;16;7;13;36
4114;14;180119;1;12;7;5;24
4115;14;151412;2;12;9;12;33
4116;14;180420;6;13;13;39;65
4117;14;180319;8;8;18;7;33
4118;14;180717;1;11;6;5;22
4119;14;151413;2;20;15;21;56
4120;14;180815;4;17;7;44;68
4121;14;151513;7;19;6;27;52
4122;14;181017;8;20;7;29;56
4123;14;181018;8;10;15;9;34
4124;14;151514;7;19;15;48;82
4125;14;180120;1;13;12;53;78
4126;14;180617;9;19;11;33;63
4127;14;180718;1;20;8;17;45
4128;14;180816;4;20;8;11;39
4129;14;180514;10;20;6;12;38
4130;14;180421;6;6;17;30;53
4131;14;180618;9;5;16;11;32
4132;14;151515;7;5;16;11;32
4133;14;151314;7;17;20;38;75
4134;14;180217;3;6;11;53;70
4135;14;180320;8;7;14;28;49
4136;14;180121;1;16;5;50;71
4137;14;181019;8;13;7;52;72
4138;14;151414;2;18;19;55;92
4139;14;180122;1;17;14;38;69
4140;14;180218;3;18;19;14;51
4141;14;180515;10;11;14;56;81
4142;14;180321;8;13;18;7;38
4143;14;180219;3;6;18;52;76
4144;14;180422;6;17;5;60;82
4145;14;180719;1;16;16;55;87
4146;14;180817;4;12;19;27;58
4147;14;181020;8;12;8;45;65
4148;14;180220;3;18;12;33;63
4149;14;181021;8;18;13;52;83
4150;14;151415;2;18;19;42;79
4151;14;180322;8;19;13;44;76
4152;14;180516;10;6;13;17;36
4153;14;180619;9;10;16;9;35
4154;14;180720;1;12;6;9;27
4155;14;180818;4;7;7;14;28
4156;14;181022;8;17;20;57;94
4157;14;180819;4;14;14;49;77
4158;14;151315;7;17;5;32;54
4159;14;180517;10;9;5;39;53
4160;14;151416;2;20;17;60;97
4161;14;180518;10;19;17;39;75
4162;14;151516;7;9;15;21;45
4163;14;180423;6;9;17;19;45
4164;14;151316;7;17;7;20;44
4165;14;151417;2;12;19;50;81
4166;14;180221;3;18;15;31;64
4167;14;151517;7;9;16;54;79
4168;14;180323;8;10;5;23;38
4169;14;180820;4;20;9;51;80
4170;14;180222;3;7;7;5;19
4171;14;181023;8;12;14;57;83
4172;14;181024;8;18;9;54;81
4173;14;180821;4;15;19;31;65
4174;14;151317;7;6;12;12;30
4175;14;180519;10;11;8;49;68
4176;14;180123;1;9;20;19;48
4177;14;180620;9;18;12;45;75
4178;14;180424;6;9;18;26;53
4179;14;180223;3;20;20;40;80
4180;14;180721;1;19;20;27;66
4181;14;180324;8;11;7;48;66
4182;14;180520;10;8;11;14;33
4183;14;180822;4;9;19;24;52
4184;14;181025;8;14;12;44;70
4185;14;151418;2;18;9;22;49
4186;14;180224;3;12;20;46;78
4187;14;180722;1;11;7;32;50
4188;14;180425;6;12;12;19;43
4189;14;180521;10;16;19;42;77
4190;14;180621;9;8;16;11;35
4191;14;180124;1;19;7;25;51
4192;14;180325;8;19;18;45;82
4193;14;151419;2;14;18;36;68
4194;14;180723;1;19;6;44;69
4195;14;180823;4;20;8;11;39
4196;14;180125;1;6;18;34;58
4197;14;151518;7;5;19;14;38
4198;14;180522;10;19;5;33;57
4199;14;180622;9;13;16;58;87
4200;14;180523;10;6;18;43;67
4201;14;180225;3;18;11;14;43
4202;14;180524;10;9;15;37;61
4203;14;180126;1;15;16;6;37
4204;14;180326;8;8;13;45;66
4205;14;180724;1;9;7;10;26
4206;14;151318;7;10;8;35;53
4207;14;180127;1;15;15;58;88
4208;14;180426;6;17;6;45;68
4209;14;180824;4;14;17;47;78
4210;14;180825;4;6;14;60;80
4211;14;180525;10;14;10;46;70
4212;14;180526;10;13;19;6;38
4213;14;180623;9;7;20;30;57
4214;14;180624;9;20;13;56;89
4215;15;151301;6;7;20;10;37
4216;15;180101;8;15;9;44;68
4217;15;180501;9;7;17;22;46
4218;15;180701;7;16;14;50;80
4219;15;180201;5;8;15;51;74
4220;15;180301;10;10;12;41;63
4221;15;151501;6;5;6;59;70
4222;15;170901;5;7;15;5;27
4223;15;151302;6;10;20;33;63
4224;15;180801;11;10;17;49;76
4225;15;181001;9;6;9;17;32
4226;15;180102;8;12;7;15;34
4227;15;180401;3;14;8;26;48
4228;15;180502;9;18;20;32;70
4229;15;180202;5;5;14;53;72
4230;15;180302;10;14;10;5;29
4231;15;180601;7;6;11;40;57
4232;15;180303;10;14;6;17;37
4233;15;180402;3;20;12;23;55
4234;15;180702;7;16;8;16;40
4235;15;180103;8;14;20;54;88
4236;15;170902;5;6;14;57;77
4237;15;180203;5;15;19;25;59
4238;15;180802;11;12;10;60;82
4239;15;180503;9;13;8;49;70
4240;15;180304;10;18;9;16;43
4241;15;180403;3;13;8;29;50
4242;15;180602;7;10;5;37;52
4243;15;180703;7;10;7;5;22
4244;15;151401;11;6;12;42;60
4245;15;180104;8;9;16;44;69
4246;15;170903;5;12;15;30;57
4247;15;180105;8;6;20;51;77
4248;15;180204;5;11;10;7;28
4249;15;180305;10;7;18;53;78
4250;15;170904;5;13;17;14;44
4251;15;180404;3;12;17;20;49
4252;15;180106;8;17;10;13;40
4253;15;151303;6;18;14;59;91
4254;15;181002;9;17;10;17;44
4255;15;180704;7;17;11;26;54
4256;15;151402;11;16;6;46;68
4257;15;180504;9;17;20;31;68
4258;15;151304;6;20;19;43;82
4259;15;151502;6;7;6;41;54
4260;15;180705;7;10;19;9;38
4261;15;180603;7;8;19;43;70
4262;15;180803;11;8;8;18;34
4263;15;180306;10;20;7;30;57
4264;15;151503;6;9;13;48;70
4265;15;180205;5;20;17;51;88
4266;15;170905;5;10;15;40;65
4267;15;181003;9;15;5;11;31
4268;15;180405;3;11;7;45;63
4269;15;151305;6;8;15;56;79
4270;15;180307;10;15;7;10;32
4271;15;181004;9;11;19;42;72
4272;15;180406;3;12;13;57;82
4273;15;180505;9;11;6;19;36
4274;15;170906;5;20;17;53;90
4275;15;180604;7;14;11;8;33
4276;15;180308;10;17;20;41;78
4277;15;151403;11;11;11;11;33
4278;15;180206;5;13;18;52;83
4279;15;180407;3;9;18;15;42
4280;15;180706;7;12;17;13;42
4281;15;180107;8;7;13;41;61
4282;15;180804;11;12;9;58;79
4283;15;180207;5;13;17;37;67
4284;15;151504;6;19;20;22;61
4285;15;180408;3;20;8;20;48
4286;15;170907;5;13;6;10;29
4287;15;180108;8;17;19;26;62
4288;15;180309;10;9;10;7;26
4289;15;181005;9;10;8;59;77
4290;15;180605;7;17;12;12;41
4291;15;180109;8;8;18;21;47
4292;15;151306;6;7;7;55;69
4293;15;180707;7;17;7;23;47
4294;15;180110;8;17;12;32;61
4295;15;180409;3;18;13;42;73
4296;15;170908;5;13;11;48;72
4297;15;180506;9;7;12;24;43
4298;15;180606;7;15;18;41;74
4299;15;151404;11;5;17;31;53
4300;15;180805;11;11;11;33;55
4301;15;151505;6;7;18;45;70
4302;15;180410;3;15;19;24;58
4303;15;151307;6;17;11;23;51
4304;15;180310;10;19;5;48;72
4305;15;170909;5;5;7;33;45
4306;15;181006;9;20;13;42;75
4307;15;180111;8;12;5;17;34
4308;15;170910;5;7;18;39;64
4309;15;151506;6;14;10;54;78
4310;15;180311;10;19;8;29;56
4311;15;180112;8;10;6;17;33
4312;15;180708;7;15;10;59;84
4313;15;180507;9;10;5;24;39
4314;15;180607;7;11;5;60;76
4315;15;180709;7;11;13;53;77
4316;15;180806;11;18;9;51;78
4317;15;181007;9;17;16;26;59
4318;15;180411;3;7;11;38;56
4319;15;180208;5;5;7;50;62
4320;15;180312;10;18;8;54;80
4321;15;180412;3;20;20;55;95
4322;15;180113;8;8;15;48;71
4323;15;181008;9;20;7;29;56
4324;15;180508;9;20;15;36;71
4325;15;151308;6;13;12;44;69
4326;15;151405;11;12;20;27;59
4327;15;180608;7;7;17;45;69
4328;15;151507;6;16;5;17;38
4329;15;180209;5;5;6;33;44
4330;15;180313;10;5;12;47;64
4331;15;180413;3;18;13;29;60
4332;15;180114;8;5;17;8;30
4333;15;180210;5;15;10;6;31
4334;15;180710;7;8;18;60;86
4335;15;180807;11;7;15;59;81
4336;15;180211;5;18;16;52;86
4337;15;180115;8;17;19;21;57
4338;15;180212;5;10;11;17;38
4339;15;180414;3;9;14;32;55
4340;15;180314;10;16;12;5;33
4341;15;180213;5;8;14;49;71
4342;15;181009;9;12;12;10;34
4343;15;180509;9;11;20;36;67
4344;15;180808;11;13;16;45;74
4345;15;180415;3;5;5;46;56
4346;15;180609;7;18;20;42;80
4347;15;151406;11;17;7;54;78
4348;15;151508;6;7;6;13;26
4349;15;180116;8;12;20;32;64
4350;15;180315;10;11;17;28;56
4351;15;181010;9;7;14;49;70
4352;15;180416;3;19;9;50;78
4353;15;180117;8;13;16;18;47
4354;15;170911;5;10;11;41;62
4355;15;180610;7;6;17;17;40
4356;15;170912;5;14;14;24;52
4357;15;180711;7;20;6;18;44
4358;15;170913;5;19;9;27;55
4359;15;180809;11;16;6;55;77
4360;15;181011;9;10;14;29;53
4361;15;170914;5;15;18;47;80
4362;15;180214;5;9;7;43;59
4363;15;180316;10;9;7;17;33
4364;15;170915;5;14;5;13;32
4365;15;151309;6;12;7;26;45
4366;15;151407;11;15;20;22;57
4367;15;180510;9;18;15;5;38
4368;15;151509;6;5;13;39;57
4369;15;151310;6;12;10;12;34
4370;15;180215;5;8;12;20;40
4371;15;180611;7;5;17;21;43
4372;15;180712;7;5;9;55;69
4373;15;180810;11;14;16;57;87
4374;15;181012;9;17;5;27;49
4375;15;180417;3;20;16;50;86
4376;15;151408;11;17;20;11;48
4377;15;181013;9;13;18;11;42
4378;15;151510;6;6;10;51;67
4379;15;151311;6;12;14;21;47
4380;15;180811;11;7;14;15;36
4381;15;180511;9;9;18;47;74
4382;15;151409;11;17;16;35;68
4383;15;180612;7;12;20;23;55
4384;15;170916;5;16;16;32;64
4385;15;180713;7;16;12;29;57
4386;15;180812;11;18;17;8;43
4387;15;180118;8;8;7;38;53
4388;15;181014;9;16;18;54;88
4389;15;180418;3;7;15;6;28
4390;15;181015;9;6;19;38;63
4391;15;180613;7;12;5;24;41
4392;15;151410;11;11;7;5;23
4393;15;180714;7;6;18;57;81
4394;15;180813;11;9;12;6;27
4395;15;180317;10;13;11;9;33
4396;15;170917;5;14;20;11;45
4397;15;180512;9;19;19;31;69
4398;15;151312;6;7;5;6;18
4399;15;170918;5;19;16;39;74
4400;15;180216;5;11;12;36;59
4401;15;151411;11;12;16;18;46
4402;15;151511;6;8;5;10;23
4403;15;180419;3;11;13;42;66
4404;15;151512;6;12;9;14;35
4405;15;180614;7;17;11;23;51
4406;15;180715;7;8;8;34;50
4407;15;180513;9;18;16;33;67
4408;15;151313;6;18;15;7;40
4409;15;180615;7;5;15;17;37
4410;15;180716;7;13;17;37;67
4411;15;180814;11;12;19;40;71
4412;15;180318;10;9;7;25;41
4413;15;180616;7;11;7;20;38
4414;15;181016;9;15;15;42;72
4415;15;180119;8;10;17;39;66
4416;15;151412;11;10;5;37;52
4417;15;180420;3;6;10;49;65
4418;15;180319;10;8;9;37;54
4419;15;180717;7;18;5;26;49
4420;15;151413;11;8;20;14;42
4421;15;180815;11;17;12;20;49
4422;15;151513;6;16;18;22;56
4423;15;181017;9;15;6;13;34
4424;15;181018;9;10;15;43;68
4425;15;151514;6;7;13;37;57
4426;15;180120;8;14;5;10;29
4427;15;180617;7;12;6;23;41
4428;15;180718;7;11;20;5;36
4429;15;180816;11;16;16;26;58
4430;15;180514;9;18;7;49;74
4431;15;180421;3;15;15;22;52
4432;15;180618;7;18;9;14;41
4433;15;151515;6;18;7;42;67
4434;15;151314;6;17;11;35;63
4435;15;180217;5;10;5;42;57
4436;15;180320;10;12;6;43;61
4437;15;180121;8;9;6;33;48
4438;15;181019;9;13;9;42;64
4439;15;151414;11;6;15;6;27
4440;15;180122;8;13;10;10;33
4441;15;180218;5;20;5;50;75
4442;15;180515;9;16;7;22;45
4443;15;180321;10;12;16;46;74
4444;15;180219;5;15;7;54;76
4445;15;180422;3;13;19;30;62
4446;15;180719;7;17;8;44;69
4447;15;180817;11;7;14;51;72
4448;15;181020;9;17;18;46;81
4449;15;180220;5;10;6;13;29
4450;15;181021;9;8;9;37;54
4451;15;151415;11;11;6;37;54
4452;15;180322;10;20;17;10;47
4453;15;180516;9;10;5;12;27
4454;15;180619;7;15;9;5;29
4455;15;180720;7;18;8;23;49
4456;15;180818;11;15;19;27;61
4457;15;181022;9;13;11;31;55
4458;15;180819;11;13;14;43;70
4459;15;151315;6;20;19;51;90
4460;15;180517;9;16;19;28;63
4461;15;151416;11;6;14;38;58
4462;15;180518;9;10;5;60;75
4463;15;151516;6;8;20;10;38
4464;15;180423;3;19;15;30;64
4465;15;151316;6;7;18;52;77
4466;15;151417;11;18;11;30;59
4467;15;180221;5;7;9;40;56
4468;15;151517;6;14;10;57;81
4469;15;180323;10;15;17;54;86
4470;15;180820;11;12;14;28;54
4471;15;180222;5;9;20;27;56
4472;15;181023;9;19;19;38;76
4473;15;181024;9;17;19;19;55
4474;15;180821;11;16;15;43;74
4475;15;151317;6;8;18;10;36
4476;15;180519;9;19;19;26;64
4477;15;180123;8;19;5;10;34
4478;15;180620;7;14;19;39;72
4479;15;180424;3;8;13;58;79
4480;15;180223;5;7;17;27;51
4481;15;180721;7;11;10;18;39
4482;15;180324;10;10;10;49;69
4483;15;180520;9;19;11;26;56
4484;15;180822;11;15;16;6;37
4485;15;181025;9;5;20;30;55
4486;15;151418;11;5;13;14;32
4487;15;180224;5;15;20;52;87
4488;15;180722;7;12;9;18;39
4489;15;180425;3;18;10;8;36
4490;15;180521;9;18;7;16;41
4491;15;180621;7;17;20;43;80
4492;15;180124;8;16;6;41;63
4493;15;180325;10;16;12;32;60
4494;15;151419;11;15;17;20;52
4495;15;180723;7;9;16;10;35
4496;15;180823;11;8;13;15;36
4497;15;180125;8;14;15;19;48
4498;15;151518;6;5;8;6;19
4499;15;180522;9;17;12;34;63
4500;15;180622;7;17;12;43;72
4501;15;180523;9;11;7;48;66
4502;15;180225;5;11;8;19;38
4503;15;180524;9;13;12;57;82
4504;15;180126;8;8;14;49;71
4505;15;180326;10;14;6;53;73
4506;15;180724;7;20;9;45;74
4507;15;151318;6;16;9;19;44
4508;15;180127;8;10;5;25;40
4509;15;180426;3;7;7;49;63
4510;15;180824;11;20;16;40;76
4511;15;180825;11;8;17;38;63
4512;15;180525;9;20;18;49;87
4513;15;180526;9;7;20;35;62
4514;15;180623;7;16;7;30;53
4515;15;180624;7;9;20;48;77
4516;16;151301;8;18;18;24;60
4517;16;180101;6;13;9;36;58
4518;16;180501;3;15;10;47;72
4519;16;180701;6;5;15;37;57
4520;16;180201;4;17;17;20;54
4521;16;180301;3;7;8;16;31
4522;16;151501;6;14;5;16;35
4523;16;170901;7;13;20;46;79
4524;16;151302;8;10;8;44;62
4525;16;180801;4;15;11;34;60
4526;16;181001;2;18;19;58;95
4527;16;180102;6;11;17;34;62
4528;16;180401;9;6;5;27;38
4529;16;180502;3;18;18;39;75
4530;16;180202;4;9;5;51;65
4531;16;180302;3;10;6;59;75
4532;16;180601;9;13;12;31;56
4533;16;180303;3;7;20;15;42
4534;16;180402;9;5;17;54;76
4535;16;180702;6;6;18;58;82
4536;16;180103;6;11;10;12;33
4537;16;170902;7;15;13;15;43
4538;16;180203;4;15;15;16;46
4539;16;180802;4;12;9;45;66
4540;16;180503;3;5;19;52;76
4541;16;180304;3;18;16;21;55
4542;16;180403;9;5;19;38;62
4543;16;180602;9;13;13;10;36
4544;16;180703;6;5;7;36;48
4545;16;151401;9;10;10;31;51
4546;16;180104;6;10;6;5;21
4547;16;170903;7;14;10;56;80
4548;16;180105;6;11;20;60;91
4549;16;180204;4;11;16;26;53
4550;16;180305;3;10;10;35;55
4551;16;170904;7;16;14;40;70
4552;16;180404;9;14;15;31;60
4553;16;180106;6;14;20;19;53
4554;16;151303;8;5;19;11;35
4555;16;181002;2;12;11;56;79
4556;16;180704;6;19;8;35;62
4557;16;151402;9;17;12;49;78
4558;16;180504;3;20;11;8;39
4559;16;151304;8;13;15;28;56
4560;16;151502;6;18;6;25;49
4561;16;180705;6;8;16;26;50
4562;16;180603;9;18;14;22;54
4563;16;180803;4;11;9;43;63
4564;16;180306;3;16;14;31;61
4565;16;151503;6;8;14;21;43
4566;16;180205;4;8;13;56;77
4567;16;170905;7;14;20;59;93
4568;16;181003;2;17;15;38;70
4569;16;180405;9;17;9;10;36
4570;16;151305;8;20;6;51;77
4571;16;180307;3;12;16;26;54
4572;16;181004;2;15;6;29;50
4573;16;180406;9;16;9;17;42
4574;16;180505;3;5;18;7;30
4575;16;170906;7;12;14;47;73
4576;16;180604;9;14;11;18;43
4577;16;180308;3;15;16;7;38
4578;16;151403;9;10;11;11;32
4579;16;180206;4;20;19;60;99
4580;16;180407;9;18;19;32;69
4581;16;180706;6;20;5;29;54
4582;16;180107;6;16;10;40;66
4583;16;180804;4;20;9;55;84
4584;16;180207;4;10;8;40;58
4585;16;151504;6;8;20;17;45
4586;16;180408;9;11;6;19;36
4587;16;170907;7;9;11;51;71
4588;16;180108;6;16;12;14;42
4589;16;180309;3;16;15;22;53
4590;16;181005;2;9;17;15;41
4591;16;180605;9;5;7;38;50
4592;16;180109;6;20;10;16;46
4593;16;151306;8;15;16;26;57
4594;16;180707;6;15;8;31;54
4595;16;180110;6;17;12;44;73
4596;16;180409;9;12;13;8;33
4597;16;170908;7;17;8;15;40
4598;16;180506;3;11;10;10;31
4599;16;180606;9;15;8;36;59
4600;16;151404;9;11;7;8;26
4601;16;180805;4;12;11;27;50
4602;16;151505;6;13;15;18;46
4603;16;180410;9;8;12;48;68
4604;16;151307;8;18;12;14;44
4605;16;180310;3;20;6;6;32
4606;16;170909;7;6;9;33;48
4607;16;181006;2;20;7;42;69
4608;16;180111;6;14;13;29;56
4609;16;170910;7;9;19;42;70
4610;16;151506;6;8;10;58;76
4611;16;180311;3;6;17;53;76
4612;16;180112;6;17;15;27;59
4613;16;180708;6;15;8;38;61
4614;16;180507;3;8;13;32;53
4615;16;180607;9;13;5;53;71
4616;16;180709;6;13;5;12;30
4617;16;180806;4;14;20;16;50
4618;16;181007;2;13;12;41;66
4619;16;180411;9;18;19;20;57
4620;16;180208;4;10;12;12;34
4621;16;180312;3;7;5;52;64
4622;16;180412;9;11;11;33;55
4623;16;180113;6;12;19;26;57
4624;16;181008;2;18;16;30;64
4625;16;180508;3;6;16;59;81
4626;16;151308;8;16;20;19;55
4627;16;151405;9;14;11;28;53
4628;16;180608;9;5;11;38;54
4629;16;151507;6;8;9;26;43
4630;16;180209;4;12;7;58;77
4631;16;180313;3;9;11;56;76
4632;16;180413;9;7;9;52;68
4633;16;180114;6;14;11;27;52
4634;16;180210;4;13;7;39;59
4635;16;180710;6;11;8;25;44
4636;16;180807;4;19;18;41;78
4637;16;180211;4;6;6;38;50
4638;16;180115;6;18;15;58;91
4639;16;180212;4;14;9;50;73
4640;16;180414;9;15;16;5;36
4641;16;180314;3;9;13;33;55
4642;16;180213;4;11;12;39;62
4643;16;181009;2;12;14;18;44
4644;16;180509;3;19;5;32;56
4645;16;180808;4;9;13;54;76
4646;16;180415;9;13;12;45;70
4647;16;180609;9;20;8;21;49
4648;16;151406;9;8;14;9;31
4649;16;151508;6;12;12;58;82
4650;16;180116;6;13;8;32;53
4651;16;180315;3;17;19;42;78
4652;16;181010;2;16;12;33;61
4653;16;180416;9;15;7;53;75
4654;16;180117;6;10;10;15;35
4655;16;170911;7;13;18;50;81
4656;16;180610;9;13;19;25;57
4657;16;170912;7;15;16;22;53
4658;16;180711;6;6;7;25;38
4659;16;170913;7;18;12;19;49
4660;16;180809;4;20;8;50;78
4661;16;181011;2;18;17;58;93
4662;16;170914;7;8;12;35;55
4663;16;180214;4;13;9;48;70
4664;16;180316;3;7;18;35;60
4665;16;170915;7;9;7;11;27
4666;16;151309;8;10;14;57;81
4667;16;151407;9;18;17;54;89
4668;16;180510;3;20;17;43;80
4669;16;151509;6;14;19;46;79
4670;16;151310;8;11;18;11;40
4671;16;180215;4;19;12;49;80
4672;16;180611;9;7;12;24;43
4673;16;180712;6;12;16;43;71
4674;16;180810;4;8;8;47;63
4675;16;181012;2;17;9;27;53
4676;16;180417;9;17;15;50;82
4677;16;151408;9;5;6;12;23
4678;16;181013;2;17;18;12;47
4679;16;151510;6;18;20;23;61
4680;16;151311;8;14;20;7;41
4681;16;180811;4;18;10;34;62
4682;16;180511;3;5;7;13;25
4683;16;151409;9;20;12;19;51
4684;16;180612;9;17;16;19;52
4685;16;170916;7;6;7;5;18
4686;16;180713;6;17;19;54;90
4687;16;180812;4;19;19;19;57
4688;16;180118;6;17;14;54;85
4689;16;181014;2;6;20;24;50
4690;16;180418;9;13;16;17;46
4691;16;181015;2;18;9;17;44
4692;16;180613;9;13;17;17;47
4693;16;151410;9;10;7;56;73
4694;16;180714;6;6;18;30;54
4695;16;180813;4;15;9;14;38
4696;16;180317;3;9;7;13;29
4697;16;170917;7;17;17;19;53
4698;16;180512;3;20;12;34;66
4699;16;151312;8;11;12;26;49
4700;16;170918;7;14;20;53;87
4701;16;180216;4;16;20;31;67
4702;16;151411;9;14;5;20;39
4703;16;151511;6;7;13;29;49
4704;16;180419;9;18;7;36;61
4705;16;151512;6;8;20;35;63
4706;16;180614;9;18;6;27;51
4707;16;180715;6;20;5;41;66
4708;16;180513;3;14;10;51;75
4709;16;151313;8;10;9;7;26
4710;16;180615;9;8;7;12;27
4711;16;180716;6;20;16;58;94
4712;16;180814;4;12;12;6;30
4713;16;180318;3;20;18;24;62
4714;16;180616;9;9;5;36;50
4715;16;181016;2;16;17;13;46
4716;16;180119;6;6;13;16;35
4717;16;151412;9;17;8;49;74
4718;16;180420;9;18;15;43;76
4719;16;180319;3;18;19;38;75
4720;16;180717;6;19;20;17;56
4721;16;151413;9;10;18;55;83
4722;16;180815;4;5;6;15;26
4723;16;151513;6;5;16;30;51
4724;16;181017;2;9;18;55;82
4725;16;181018;2;6;10;58;74
4726;16;151514;6;19;15;47;81
4727;16;180120;6;18;17;47;82
4728;16;180617;9;6;14;31;51
4729;16;180718;6;16;6;56;78
4730;16;180816;4;7;6;45;58
4731;16;180514;3;12;6;58;76
4732;16;180421;9;15;16;21;52
4733;16;180618;9;5;19;36;60
4734;16;151515;6;13;17;28;58
4735;16;151314;8;20;15;27;62
4736;16;180217;4;6;18;17;41
4737;16;180320;3;5;15;6;26
4738;16;180121;6;5;18;20;43
4739;16;181019;2;17;12;53;82
4740;16;151414;9;6;20;59;85
4741;16;180122;6;20;19;54;93
4742;16;180218;4;11;16;46;73
4743;16;180515;3;15;15;35;65
4744;16;180321;3;12;7;19;38
4745;16;180219;4;14;17;42;73
4746;16;180422;9;19;19;34;72
4747;16;180719;6;9;9;50;68
4748;16;180817;4;12;19;56;87
4749;16;181020;2;20;8;5;33
4750;16;180220;4;9;17;24;50
4751;16;181021;2;16;11;34;61
4752;16;151415;9;20;12;20;52
4753;16;180322;3;6;17;10;33
4754;16;180516;3;8;13;42;63
4755;16;180619;9;11;7;40;58
4756;16;180720;6;19;7;36;62
4757;16;180818;4;8;8;58;74
4758;16;181022;2;18;20;46;84
4759;16;180819;4;7;11;35;53
4760;16;151315;8;5;5;12;22
4761;16;180517;3;17;9;56;82
4762;16;151416;9;5;19;56;80
4763;16;180518;3;5;19;59;83
4764;16;151516;6;11;18;58;87
4765;16;180423;9;17;20;38;75
4766;16;151316;8;11;15;59;85
4767;16;151417;9;15;19;50;84
4768;16;180221;4;7;9;27;43
4769;16;151517;6;11;13;51;75
4770;16;180323;3;5;5;20;30
4771;16;180820;4;8;10;16;34
4772;16;180222;4;16;20;27;63
4773;16;181023;2;16;11;51;78
4774;16;181024;2;15;13;30;58
4775;16;180821;4;6;19;50;75
4776;16;151317;8;5;10;21;36
4777;16;180519;3;19;17;50;86
4778;16;180123;6;20;7;21;48
4779;16;180620;9;15;8;38;61
4780;16;180424;9;15;5;9;29
4781;16;180223;4;20;15;36;71
4782;16;180721;6;7;6;46;59
4783;16;180324;3;18;15;16;49
4784;16;180520;3;18;12;55;85
4785;16;180822;4;11;20;33;64
4786;16;181025;2;13;15;57;85
4787;16;151418;9;11;13;23;47
4788;16;180224;4;13;8;29;50
4789;16;180722;6;20;6;23;49
4790;16;180425;9;19;20;10;49
4791;16;180521;3;10;8;42;60
4792;16;180621;9;17;13;13;43
4793;16;180124;6;6;17;41;64
4794;16;180325;3;14;15;11;40
4795;16;151419;9;18;19;48;85
4796;16;180723;6;20;19;21;60
4797;16;180823;4;19;7;49;75
4798;16;180125;6;10;18;56;84
4799;16;151518;6;10;8;24;42
4800;16;180522;3;13;11;10;34
4801;16;180622;9;18;15;35;68
4802;16;180523;3;7;7;21;35
4803;16;180225;4;5;7;26;38
4804;16;180524;3;18;15;18;51
4805;16;180126;6;12;7;36;55
4806;16;180326;3;10;16;31;57
4807;16;180724;6;7;6;42;55
4808;16;151318;8;13;6;24;43
4809;16;180127;6;19;12;7;38
4810;16;180426;9;19;9;55;83
4811;16;180824;4;19;15;42;76
4812;16;180825;4;19;6;21;46
4813;16;180525;3;8;20;20;48
4814;16;180526;3;5;10;40;55
4815;16;180623;9;15;5;15;35
4816;16;180624;9;8;12;42;62
4817;17;151301;2;20;20;6;46
4818;17;180101;4;5;17;26;48
4819;17;180501;4;12;17;21;50
4820;17;180701;8;9;10;32;51
4821;17;180201;9;13;15;18;46
4822;17;180301;9;7;7;54;68
4823;17;151501;10;18;14;55;87
4824;17;170901;7;18;16;27;61
4825;17;151302;2;18;18;12;48
4826;17;180801;2;10;19;51;80
4827;17;181001;2;7;11;59;77
4828;17;180102;4;14;6;20;40
4829;17;180401;5;17;16;31;64
4830;17;180502;4;15;12;48;75
4831;17;180202;9;11;7;18;36
4832;17;180302;9;14;6;21;41
4833;17;180601;8;8;6;40;54
4834;17;180303;9;16;19;17;52
4835;17;180402;5;15;14;30;59
4836;17;180702;8;12;18;55;85
4837;17;180103;4;7;20;46;73
4838;17;170902;7;7;5;24;36
4839;17;180203;9;11;18;39;68
4840;17;180802;2;12;11;31;54
4841;17;180503;4;18;13;32;63
4842;17;180304;9;7;17;34;58
4843;17;180403;5;5;19;26;50
4844;17;180602;8;7;13;12;32
4845;17;180703;8;10;8;44;62
4846;17;151401;8;13;13;5;31
4847;17;180104;4;19;15;50;84
4848;17;170903;7;8;5;50;63
4849;17;180105;4;10;12;36;58
4850;17;180204;9;14;18;43;75
4851;17;180305;9;8;9;59;76
4852;17;170904;7;13;16;54;83
4853;17;180404;5;6;17;40;63
4854;17;180106;4;15;15;16;46
4855;17;151303;2;8;12;47;67
4856;17;181002;2;5;9;32;46
4857;17;180704;8;14;10;15;39
4858;17;151402;8;14;18;29;61
4859;17;180504;4;17;18;18;53
4860;17;151304;2;12;6;36;54
4861;17;151502;10;6;14;41;61
4862;17;180705;8;7;9;60;76
4863;17;180603;8;6;16;10;32
4864;17;180803;2;6;17;34;57
4865;17;180306;9;16;7;6;29
4866;17;151503;10;17;7;53;77
4867;17;180205;9;12;17;16;45
4868;17;170905;7;19;9;9;37
4869;17;181003;2;11;15;59;85
4870;17;180405;5;7;12;10;29
4871;17;151305;2;20;8;35;63
4872;17;180307;9;13;10;25;48
4873;17;181004;2;17;10;8;35
4874;17;180406;5;17;20;27;64
4875;17;180505;4;9;5;45;59
4876;17;170906;7;17;19;35;71
4877;17;180604;8;10;6;59;75
4878;17;180308;9;12;18;23;53
4879;17;151403;8;15;16;15;46
4880;17;180206;9;17;13;55;85
4881;17;180407;5;7;14;47;68
4882;17;180706;8;15;12;38;65
4883;17;180107;4;13;7;7;27
4884;17;180804;2;9;13;44;66
4885;17;180207;9;5;9;18;32
4886;17;151504;10;8;17;13;38
4887;17;180408;5;5;9;34;48
4888;17;170907;7;14;14;39;67
4889;17;180108;4;17;19;10;46
4890;17;180309;9;17;18;33;68
4891;17;181005;2;14;16;39;69
4892;17;180605;8;8;8;12;28
4893;17;180109;4;5;8;49;62
4894;17;151306;2;12;15;6;33
4895;17;180707;8;5;17;26;48
4896;17;180110;4;10;14;17;41
4897;17;180409;5;16;6;29;51
4898;17;170908;7;19;19;20;58
4899;17;180506;4;15;11;34;60
4900;17;180606;8;5;15;56;76
4901;17;151404;8;5;12;46;63
4902;17;180805;2;10;14;33;57
4903;17;151505;10;19;13;60;92
4904;17;180410;5;5;12;51;68
4905;17;151307;2;11;7;42;60
4906;17;180310;9;20;20;41;81
4907;17;170909;7;11;18;53;82
4908;17;181006;2;19;15;41;75
4909;17;180111;4;13;16;10;39
4910;17;170910;7;9;17;23;49
4911;17;151506;10;19;19;24;62
4912;17;180311;9;14;18;7;39
4913;17;180112;4;18;16;16;50
4914;17;180708;8;16;8;52;76
4915;17;180507;4;10;17;35;62
4916;17;180607;8;10;20;24;54
4917;17;180709;8;14;10;29;53
4918;17;180806;2;14;20;53;87
4919;17;181007;2;8;16;43;67
4920;17;180411;5;14;18;27;59
4921;17;180208;9;10;12;58;80
4922;17;180312;9;13;7;12;32
4923;17;180412;5;20;7;24;51
4924;17;180113;4;18;5;46;69
4925;17;181008;2;14;19;24;57
4926;17;180508;4;5;6;12;23
4927;17;151308;2;13;11;5;29
4928;17;151405;8;17;12;15;44
4929;17;180608;8;11;10;54;75
4930;17;151507;10;20;17;57;94
4931;17;180209;9;8;15;16;39
4932;17;180313;9;13;13;22;48
4933;17;180413;5;14;7;48;69
4934;17;180114;4;20;15;56;91
4935;17;180210;9;17;17;24;58
4936;17;180710;8;7;20;23;50
4937;17;180807;2;9;7;37;53
4938;17;180211;9;14;5;52;71
4939;17;180115;4;14;7;27;48
4940;17;180212;9;7;9;35;51
4941;17;180414;5;15;15;32;62
4942;17;180314;9;15;20;13;48
4943;17;180213;9;17;5;32;54
4944;17;181009;2;20;5;38;63
4945;17;180509;4;13;5;38;56
4946;17;180808;2;17;12;52;81
4947;17;180415;5;16;6;27;49
4948;17;180609;8;15;6;7;28
4949;17;151406;8;14;5;23;42
4950;17;151508;10;9;9;15;33
4951;17;180116;4;20;17;46;83
4952;17;180315;9;9;7;18;34
4953;17;181010;2;11;15;14;40
4954;17;180416;5;7;16;26;49
4955;17;180117;4;15;6;36;57
4956;17;170911;7;10;12;19;41
4957;17;180610;8;11;11;49;71
4958;17;170912;7;14;7;40;61
4959;17;180711;8;15;7;22;44
4960;17;170913;7;12;20;49;81
4961;17;180809;2;18;8;9;35
4962;17;181011;2;15;20;22;57
4963;17;170914;7;10;16;33;59
4964;17;180214;9;19;8;29;56
4965;17;180316;9;11;6;7;24
4966;17;170915;7;6;7;33;46
4967;17;151309;2;6;5;14;25
4968;17;151407;8;20;6;58;84
4969;17;180510;4;7;7;20;34
4970;17;151509;10;15;9;54;78
4971;17;151310;2;14;18;8;40
4972;17;180215;9;5;13;58;76
4973;17;180611;8;19;10;44;73
4974;17;180712;8;11;19;47;77
4975;17;180810;2;15;9;35;59
4976;17;181012;2;18;6;27;51
4977;17;180417;5;13;9;43;65
4978;17;151408;8;11;10;33;54
4979;17;181013;2;8;10;33;51
4980;17;151510;10;13;7;11;31
4981;17;151311;2;10;9;58;77
4982;17;180811;2;11;5;53;69
4983;17;180511;4;16;10;17;43
4984;17;151409;8;11;7;32;50
4985;17;180612;8;7;6;33;46
4986;17;170916;7;6;12;30;48
4987;17;180713;8;8;17;43;68
4988;17;180812;2;6;17;20;43
4989;17;180118;4;18;8;26;52
4990;17;181014;2;8;7;52;67
4991;17;180418;5;17;13;8;38
4992;17;181015;2;13;17;18;48
4993;17;180613;8;18;17;60;95
4994;17;151410;8;9;15;14;38
4995;17;180714;8;17;7;24;48
4996;17;180813;2;20;19;42;81
4997;17;180317;9;15;7;27;49
4998;17;170917;7;5;11;21;37
4999;17;180512;4;5;11;52;68
5000;17;151312;2;10;15;44;69
5001;17;170918;7;19;9;17;45
5002;17;180216;9;12;8;45;65
5003;17;151411;8;20;8;10;38
5004;17;151511;10;5;20;23;48
5005;17;180419;5;11;7;9;27
5006;17;151512;10;16;7;52;75
5007;17;180614;8;16;6;48;70
5008;17;180715;8;7;10;43;60
5009;17;180513;4;20;10;7;37
5010;17;151313;2;14;10;42;66
5011;17;180615;8;11;12;39;62
5012;17;180716;8;6;7;35;48
5013;17;180814;2;7;11;37;55
5014;17;180318;9;12;6;40;58
5015;17;180616;8;15;12;21;48
5016;17;181016;2;10;13;33;56
5017;17;180119;4;6;14;18;38
5018;17;151412;8;9;19;15;43
5019;17;180420;5;16;19;31;66
5020;17;180319;9;14;6;52;72
5021;17;180717;8;9;9;5;23
5022;17;151413;8;15;19;17;51
5023;17;180815;2;6;16;33;55
5024;17;151513;10;18;11;27;56
5025;17;181017;2;17;13;31;61
5026;17;181018;2;13;9;40;62
5027;17;151514;10;16;6;8;30
5028;17;180120;4;9;14;51;74
5029;17;180617;8;7;18;29;54
5030;17;180718;8;9;7;36;52
5031;17;180816;2;15;11;31;57
5032;17;180514;4;15;11;29;55
5033;17;180421;5;13;7;17;37
5034;17;180618;8;17;14;58;89
5035;17;151515;10;19;5;18;42
5036;17;151314;2;14;17;54;85
5037;17;180217;9;5;8;27;40
5038;17;180320;9;14;16;36;66
5039;17;180121;4;20;7;27;54
5040;17;181019;2;7;18;17;42
5041;17;151414;8;13;13;59;85
5042;17;180122;4;10;10;54;74
5043;17;180218;9;5;6;44;55
5044;17;180515;4;8;18;49;75
5045;17;180321;9;11;5;8;24
5046;17;180219;9;8;19;24;51
5047;17;180422;5;20;7;5;32
5048;17;180719;8;18;9;48;75
5049;17;180817;2;18;6;16;40
5050;17;181020;2;17;5;59;81
5051;17;180220;9;19;7;6;32
5052;17;181021;2;12;11;59;82
5053;17;151415;8;16;15;5;36
5054;17;180322;9;10;15;16;41
5055;17;180516;4;13;8;53;74
5056;17;180619;8;7;11;60;78
5057;17;180720;8;18;8;55;81
5058;17;180818;2;18;10;19;47
5059;17;181022;2;5;20;29;54
5060;17;180819;2;19;9;56;84
5061;17;151315;2;16;19;8;43
5062;17;180517;4;19;20;20;59
5063;17;151416;8;14;18;47;79
5064;17;180518;4;16;19;13;48
5065;17;151516;10;11;6;46;63
5066;17;180423;5;14;6;8;28
5067;17;151316;2;12;9;19;40
5068;17;151417;8;14;5;56;75
5069;17;180221;9;19;18;35;72
5070;17;151517;10;7;15;32;54
5071;17;180323;9;13;19;55;87
5072;17;180820;2;18;11;14;43
5073;17;180222;9;20;6;9;35
5074;17;181023;2;5;8;15;28
5075;17;181024;2;12;19;32;63
5076;17;180821;2;18;20;17;55
5077;17;151317;2;7;13;59;79
5078;17;180519;4;13;7;8;28
5079;17;180123;4;9;8;60;77
5080;17;180620;8;5;9;38;52
5081;17;180424;5;5;20;23;48
5082;17;180223;9;11;8;41;60
5083;17;180721;8;6;13;6;25
5084;17;180324;9;16;11;28;55
5085;17;180520;4;18;20;32;70
5086;17;180822;2;9;6;42;57
5087;17;181025;2;9;7;21;37
5088;17;151418;8;10;17;33;60
5089;17;180224;9;15;20;35;70
5090;17;180722;8;20;7;11;38
5091;17;180425;5;20;13;52;85
5092;17;180521;4;10;5;58;73
5093;17;180621;8;10;5;52;67
5094;17;180124;4;7;10;28;45
5095;17;180325;9;7;7;22;36
5096;17;151419;8;18;11;13;42
5097;17;180723;8;7;5;12;24
5098;17;180823;2;19;20;46;85
5099;17;180125;4;9;9;29;47
5100;17;151518;10;10;15;33;58
5101;17;180522;4;15;17;22;54
5102;17;180622;8;8;7;59;74
5103;17;180523;4;13;10;25;48
5104;17;180225;9;18;8;49;75
5105;17;180524;4;16;7;46;69
5106;17;180126;4;17;12;16;45
5107;17;180326;9;6;20;11;37
5108;17;180724;8;9;11;51;71
5109;17;151318;2;6;13;7;26
5110;17;180127;4;7;5;36;48
5111;17;180426;5;10;19;55;84
5112;17;180824;2;11;13;29;53
5113;17;180825;2;14;9;51;74
5114;17;180525;4;12;9;38;59
5115;17;180526;4;11;18;20;49
5116;17;180623;8;10;13;45;68
5117;17;180624;8;5;17;28;50
5118;18;151301;9;5;16;25;46
5119;18;180101;5;19;6;51;76
5120;18;180501;10;10;20;46;76
5121;18;180701;3;13;8;50;71
5122;18;180201;4;6;8;51;65
5123;18;180301;3;16;9;53;78
5124;18;151501;11;13;13;17;43
5125;18;170901;6;6;6;9;21
5126;18;151302;9;5;10;53;68
5127;18;180801;8;15;9;52;76
5128;18;181001;8;12;20;23;55
5129;18;180102;5;8;8;37;53
5130;18;180401;1;10;19;38;67
5131;18;180502;10;9;13;9;31
5132;18;180202;4;5;10;26;41
5133;18;180302;3;14;20;59;93
5134;18;180601;11;16;9;35;60
5135;18;180303;3;20;16;56;92
5136;18;180402;1;16;17;26;59
5137;18;180702;3;9;15;53;77
5138;18;180103;5;6;8;41;55
5139;18;170902;6;5;20;18;43
5140;18;180203;4;18;7;13;38
5141;18;180802;8;11;20;51;82
5142;18;180503;10;17;8;58;83
5143;18;180304;3;14;14;40;68
5144;18;180403;1;11;11;33;55
5145;18;180602;11;10;10;32;52
5146;18;180703;3;17;11;60;88
5147;18;151401;10;5;14;11;30
5148;18;180104;5;6;16;48;70
5149;18;170903;6;14;18;8;40
5150;18;180105;5;12;19;16;47
5151;18;180204;4;20;18;29;67
5152;18;180305;3;17;15;59;91
5153;18;170904;6;18;17;18;53
5154;18;180404;1;6;13;59;78
5155;18;180106;5;7;19;5;31
5156;18;151303;9;9;11;44;64
5157;18;181002;8;8;10;40;58
5158;18;180704;3;13;7;9;29
5159;18;151402;10;18;7;41;66
5160;18;180504;10;8;14;42;64
5161;18;151304;9;17;5;42;64
5162;18;151502;11;16;5;32;53
5163;18;180705;3;16;13;13;42
5164;18;180603;11;13;15;19;47
5165;18;180803;8;5;9;52;66
5166;18;180306;3;10;10;17;37
5167;18;151503;11;11;7;15;33
5168;18;180205;4;8;7;48;63
5169;18;170905;6;18;12;43;73
5170;18;181003;8;20;9;22;51
5171;18;180405;1;12;6;8;26
5172;18;151305;9;18;8;14;40
5173;18;180307;3;20;13;57;90
5174;18;181004;8;18;20;35;73
5175;18;180406;1;17;13;10;40
5176;18;180505;10;19;19;59;97
5177;18;170906;6;9;6;46;61
5178;18;180604;11;7;6;29;42
5179;18;180308;3;11;10;13;34
5180;18;151403;10;18;11;20;49
5181;18;180206;4;13;7;10;30
5182;18;180407;1;16;19;51;86
5183;18;180706;3;12;18;51;81
5184;18;180107;5;7;18;59;84
5185;18;180804;8;15;16;9;40
5186;18;180207;4;5;20;18;43
5187;18;151504;11;20;10;12;42
5188;18;180408;1;10;16;56;82
5189;18;170907;6;6;13;9;28
5190;18;180108;5;8;15;28;51
5191;18;180309;3;5;19;20;44
5192;18;181005;8;13;11;32;56
5193;18;180605;11;8;18;20;46
5194;18;180109;5;15;13;5;33
5195;18;151306;9;20;19;56;95
5196;18;180707;3;5;14;35;54
5197;18;180110;5;6;8;21;35
5198;18;180409;1;16;16;30;62
5199;18;170908;6;8;17;47;72
5200;18;180506;10;15;10;27;52
5201;18;180606;11;16;16;23;55
5202;18;151404;10;19;19;6;44
5203;18;180805;8;9;14;37;60
5204;18;151505;11;19;8;57;84
5205;18;180410;1;15;8;32;55
5206;18;151307;9;5;20;32;57
5207;18;180310;3;11;15;24;50
5208;18;170909;6;13;12;57;82
5209;18;181006;8;20;11;44;75
5210;18;180111;5;20;19;9;48
5211;18;170910;6;20;12;17;49
5212;18;151506;11;14;9;45;68
5213;18;180311;3;20;5;28;53
5214;18;180112;5;8;20;11;39
5215;18;180708;3;13;15;56;84
5216;18;180507;10;19;18;47;84
5217;18;180607;11;8;15;48;71
5218;18;180709;3;20;14;18;52
5219;18;180806;8;12;10;5;27
5220;18;181007;8;15;9;19;43
5221;18;180411;1;6;16;44;66
5222;18;180208;4;7;9;54;70
5223;18;180312;3;20;10;29;59
5224;18;180412;1;15;20;10;45
5225;18;180113;5;18;7;56;81
5226;18;181008;8;9;19;50;78
5227;18;180508;10;17;9;41;67
5228;18;151308;9;20;11;26;57
5229;18;151405;10;8;16;36;60
5230;18;180608;11;14;16;32;62
5231;18;151507;11;17;8;54;79
5232;18;180209;4;13;6;31;50
5233;18;180313;3;20;14;37;71
5234;18;180413;1;14;18;54;86
5235;18;180114;5;13;8;10;31
5236;18;180210;4;5;8;30;43
5237;18;180710;3;14;16;30;60
5238;18;180807;8;6;13;53;72
5239;18;180211;4;15;6;43;64
5240;18;180115;5;18;15;50;83
5241;18;180212;4;6;11;40;57
5242;18;180414;1;6;19;28;53
5243;18;180314;3;14;15;56;85
5244;18;180213;4;17;20;13;50
5245;18;181009;8;16;16;46;78
5246;18;180509;10;13;18;13;44
5247;18;180808;8;20;11;19;50
5248;18;180415;1;20;8;20;48
5249;18;180609;11;10;10;16;36
5250;18;151406;10;18;9;54;81
5251;18;151508;11;20;13;9;42
5252;18;180116;5;15;13;44;72
5253;18;180315;3;12;9;42;63
5254;18;181010;8;16;6;59;81
5255;18;180416;1;10;15;37;62
5256;18;180117;5;20;10;12;42
5257;18;170911;6;19;19;27;65
5258;18;180610;11;14;6;28;48
5259;18;170912;6;15;6;15;36
5260;18;180711;3;11;17;48;76
5261;18;170913;6;12;20;23;55
5262;18;180809;8;8;20;16;44
5263;18;181011;8;14;9;38;61
5264;18;170914;6;14;16;53;83
5265;18;180214;4;16;19;43;78
5266;18;180316;3;17;13;58;88
5267;18;170915;6;16;17;12;45
5268;18;151309;9;14;11;38;63
5269;18;151407;10;12;16;54;82
5270;18;180510;10;11;9;26;46
5271;18;151509;11;19;20;15;54
5272;18;151310;9;17;8;51;76
5273;18;180215;4;11;20;32;63
5274;18;180611;11;14;10;21;45
5275;18;180712;3;5;18;19;42
5276;18;180810;8;13;11;16;40
5277;18;181012;8;15;15;9;39
5278;18;180417;1;7;18;17;42
5279;18;151408;10;13;14;54;81
5280;18;181013;8;14;5;12;31
5281;18;151510;11;20;19;58;97
5282;18;151311;9;8;7;34;49
5283;18;180811;8;19;11;56;86
5284;18;180511;10;19;9;57;85
5285;18;151409;10;11;13;15;39
5286;18;180612;11;17;16;23;56
5287;18;170916;6;9;7;11;27
5288;18;180713;3;11;13;38;62
5289;18;180812;8;11;9;8;28
5290;18;180118;5;16;11;53;80
5291;18;181014;8;16;12;32;60
5292;18;180418;1;5;6;25;36
5293;18;181015;8;6;18;16;40
5294;18;180613;11;17;19;16;52
5295;18;151410;10;9;7;26;42
5296;18;180714;3;13;18;5;36
5297;18;180813;8;8;16;39;63
5298;18;180317;3;11;9;50;70
5299;18;170917;6;18;20;43;81
5300;18;180512;10;5;10;44;59
5301;18;151312;9;10;7;59;76
5302;18;170918;6;13;15;20;48
5303;18;180216;4;19;5;45;69
5304;18;151411;10;17;19;31;67
5305;18;151511;11;17;20;39;76
5306;18;180419;1;20;10;40;70
5307;18;151512;11;9;13;28;50
5308;18;180614;11;19;16;9;44
5309;18;180715;3;16;12;6;34
5310;18;180513;10;10;20;15;45
5311;18;151313;9;11;16;22;49
5312;18;180615;11;14;17;20;51
5313;18;180716;3;9;16;9;34
5314;18;180814;8;19;15;60;94
5315;18;180318;3;9;17;49;75
5316;18;180616;11;8;18;5;31
5317;18;181016;8;8;7;51;66
5318;18;180119;5;10;13;39;62
5319;18;151412;10;12;13;43;68
5320;18;180420;1;18;11;41;70
5321;18;180319;3;7;9;30;46
5322;18;180717;3;5;18;15;38
5323;18;151413;10;10;10;35;55
5324;18;180815;8;15;6;54;75
5325;18;151513;11;20;18;50;88
5326;18;181017;8;19;9;59;87
5327;18;181018;8;12;13;5;30
5328;18;151514;11;13;16;60;89
5329;18;180120;5;14;16;27;57
5330;18;180617;11;5;6;15;26
5331;18;180718;3;10;10;49;69
5332;18;180816;8;9;11;41;61
5333;18;180514;10;8;16;50;74
5334;18;180421;1;20;5;48;73
5335;18;180618;11;9;10;46;65
5336;18;151515;11;9;13;9;31
5337;18;151314;9;9;12;27;48
5338;18;180217;4;6;7;15;28
5339;18;180320;3;15;5;32;52
5340;18;180121;5;18;8;54;80
5341;18;181019;8;8;13;52;73
5342;18;151414;10;8;12;29;49
5343;18;180122;5;5;6;24;35
5344;18;180218;4;9;10;48;67
5345;18;180515;10;10;20;17;47
5346;18;180321;3;6;19;8;33
5347;18;180219;4;12;8;6;26
5348;18;180422;1;10;13;33;56
5349;18;180719;3;12;5;11;28
5350;18;180817;8;18;12;6;36
5351;18;181020;8;6;5;37;48
5352;18;180220;4;8;16;36;60
5353;18;181021;8;19;17;51;87
5354;18;151415;10;14;14;49;77
5355;18;180322;3;12;18;56;86
5356;18;180516;10;7;13;53;73
5357;18;180619;11;6;17;56;79
5358;18;180720;3;18;10;51;79
5359;18;180818;8;18;19;37;74
5360;18;181022;8;11;16;51;78
5361;18;180819;8;8;10;6;24
5362;18;151315;9;12;19;43;74
5363;18;180517;10;9;9;28;46
5364;18;151416;10;5;15;41;61
5365;18;180518;10;5;13;33;51
5366;18;151516;11;8;9;26;43
5367;18;180423;1;13;8;42;63
5368;18;151316;9;14;16;60;90
5369;18;151417;10;11;19;28;58
5370;18;180221;4;13;14;8;35
5371;18;151517;11;15;13;13;41
5372;18;180323;3;8;13;45;66
5373;18;180820;8;11;17;30;58
5374;18;180222;4;13;13;33;59
5375;18;181023;8;18;20;33;71
5376;18;181024;8;12;19;51;82
5377;18;180821;8;12;6;54;72
5378;18;151317;9;11;7;31;49
5379;18;180519;10;13;15;48;76
5380;18;180123;5;20;19;60;99
5381;18;180620;11;15;16;44;75
5382;18;180424;1;14;18;29;61
5383;18;180223;4;9;13;41;63
5384;18;180721;3;9;10;49;68
5385;18;180324;3;18;11;8;37
5386;18;180520;10;20;7;51;78
5387;18;180822;8;5;11;20;36
5388;18;181025;8;20;5;50;75
5389;18;151418;10;18;10;21;49
5390;18;180224;4;12;8;58;78
5391;18;180722;3;5;6;6;17
5392;18;180425;1;12;17;46;75
5393;18;180521;10;8;13;39;60
5394;18;180621;11;20;16;47;83
5395;18;180124;5;19;6;41;66
5396;18;180325;3;15;9;7;31
5397;18;151419;10;20;12;34;66
5398;18;180723;3;12;6;60;78
5399;18;180823;8;13;12;37;62
5400;18;180125;5;12;13;54;79
5401;18;151518;11;20;13;8;41
5402;18;180522;10;7;7;36;50
5403;18;180622;11;19;14;33;66
5404;18;180523;10;16;9;13;38
5405;18;180225;4;18;9;42;69
5406;18;180524;10;12;9;16;37
5407;18;180126;5;10;13;10;33
5408;18;180326;3;9;18;42;69
5409;18;180724;3;12;19;5;36
5410;18;151318;9;9;16;28;53
5411;18;180127;5;14;20;6;40
5412;18;180426;1;9;12;5;26
5413;18;180824;8;13;12;5;30
5414;18;180825;8;7;10;32;49
5415;18;180525;10;20;7;23;50
5416;18;180526;10;20;19;30;69
5417;18;180623;11;15;6;36;57
5418;18;180624;11;8;5;8;21
5419;19;151301;11;20;13;6;39
5420;19;180101;1;5;9;24;38
5421;19;180501;10;8;11;38;57
5422;19;180701;11;11;16;59;86
5423;19;180201;1;17;12;36;65
5424;19;180301;4;8;15;20;43
5425;19;151501;2;9;12;30;51
5426;19;170901;9;10;5;55;70
5427;19;151302;11;7;11;48;66
5428;19;180801;2;14;13;36;63
5429;19;181001;9;12;5;48;65
5430;19;180102;1;17;10;12;39
5431;19;180401;2;12;16;34;62
5432;19;180502;10;9;17;14;40
5433;19;180202;1;16;10;12;38
5434;19;180302;4;8;13;9;30
5435;19;180601;3;16;6;21;43
5436;19;180303;4;8;17;44;69
5437;19;180402;2;11;9;34;54
5438;19;180702;11;18;12;38;68
5439;19;180103;1;19;12;28;59
5440;19;170902;9;11;6;14;31
5441;19;180203;1;16;15;39;70
5442;19;180802;2;8;15;14;37
5443;19;180503;10;7;17;32;56
5444;19;180304;4;17;6;57;80
5445;19;180403;2;17;20;57;94
5446;19;180602;3;11;18;26;55
5447;19;180703;11;11;16;37;64
5448;19;151401;2;11;6;46;63
5449;19;180104;1;16;17;11;44
5450;19;170903;9;12;6;59;77
5451;19;180105;1;5;6;38;49
5452;19;180204;1;13;5;7;25
5453;19;180305;4;18;19;32;69
5454;19;170904;9;12;20;48;80
5455;19;180404;2;19;14;48;81
5456;19;180106;1;19;10;31;60
5457;19;151303;11;16;11;12;39
5458;19;181002;9;9;13;31;53
5459;19;180704;11;5;12;8;25
5460;19;151402;2;8;17;25;50
5461;19;180504;10;14;16;41;71
5462;19;151304;11;20;9;25;54
5463;19;151502;2;6;5;17;28
5464;19;180705;11;11;13;23;47
5465;19;180603;3;7;11;56;74
5466;19;180803;2;18;20;32;70
5467;19;180306;4;16;12;11;39
5468;19;151503;2;11;10;17;38
5469;19;180205;1;14;17;6;37
5470;19;170905;9;12;6;52;70
5471;19;181003;9;16;7;22;45
5472;19;180405;2;16;14;52;82
5473;19;151305;11;17;8;34;59
5474;19;180307;4;9;12;48;69
5475;19;181004;9;16;8;41;65
5476;19;180406;2;18;15;8;41
5477;19;180505;10;18;6;41;65
5478;19;170906;9;13;12;16;41
5479;19;180604;3;12;13;43;68
5480;19;180308;4;11;17;16;44
5481;19;151403;2;16;13;27;56
5482;19;180206;1;17;10;47;74
5483;19;180407;2;9;16;31;56
5484;19;180706;11;6;20;14;40
5485;19;180107;1;5;20;59;84
5486;19;180804;2;16;15;17;48
5487;19;180207;1;13;11;27;51
5488;19;151504;2;18;8;10;36
5489;19;180408;2;19;18;9;46
5490;19;170907;9;5;13;12;30
5491;19;180108;1;10;19;12;41
5492;19;180309;4;19;6;28;53
5493;19;181005;9;15;16;24;55
5494;19;180605;3;15;6;53;74
5495;19;180109;1;5;20;40;65
5496;19;151306;11;6;16;8;30
5497;19;180707;11;16;14;38;68
5498;19;180110;1;18;11;14;43
5499;19;180409;2;8;6;55;69
5500;19;170908;9;11;18;39;68
5501;19;180506;10;11;7;47;65
5502;19;180606;3;17;10;22;49
5503;19;151404;2;8;15;31;54
5504;19;180805;2;5;8;49;62
5505;19;151505;2;6;13;47;66
5506;19;180410;2;13;15;54;82
5507;19;151307;11;5;18;55;78
5508;19;180310;4;12;10;47;69
5509;19;170909;9;17;14;35;66
5510;19;181006;9;17;10;49;76
5511;19;180111;1;16;9;13;38
5512;19;170910;9;8;8;38;54
5513;19;151506;2;19;12;58;89
5514;19;180311;4;9;16;27;52
5515;19;180112;1;16;17;45;78
5516;19;180708;11;16;6;59;81
5517;19;180507;10;10;19;18;47
5518;19;180607;3;7;5;9;21
5519;19;180709;11;6;8;15;29
5520;19;180806;2;8;6;32;46
5521;19;181007;9;18;7;37;62
5522;19;180411;2;5;6;45;56
5523;19;180208;1;19;14;20;53
5524;19;180312;4;13;18;45;76
5525;19;180412;2;13;18;59;90
5526;19;180113;1;12;8;50;70
5527;19;181008;9;16;19;12;47
5528;19;180508;10;6;13;47;66
5529;19;151308;11;19;5;30;54
5530;19;151405;2;19;11;52;82
5531;19;180608;3;18;7;8;33
5532;19;151507;2;5;12;39;56
5533;19;180209;1;12;5;10;27
5534;19;180313;4;8;13;44;65
5535;19;180413;2;11;20;50;81
5536;19;180114;1;6;14;24;44
5537;19;180210;1;15;7;49;71
5538;19;180710;11;13;17;25;55
5539;19;180807;2;11;9;30;50
5540;19;180211;1;18;16;12;46
5541;19;180115;1;6;17;6;29
5542;19;180212;1;12;17;39;68
5543;19;180414;2;5;17;45;67
5544;19;180314;4;17;8;45;70
5545;19;180213;1;13;16;10;39
5546;19;181009;9;16;6;47;69
5547;19;180509;10;5;18;24;47
5548;19;180808;2;15;15;25;55
5549;19;180415;2;12;14;16;42
5550;19;180609;3;12;19;42;73
5551;19;151406;2;15;9;20;44
5552;19;151508;2;15;14;34;63
5553;19;180116;1;20;6;29;55
5554;19;180315;4;20;7;55;82
5555;19;181010;9;13;14;54;81
5556;19;180416;2;6;12;22;40
5557;19;180117;1;8;11;52;71
5558;19;170911;9;5;16;55;76
5559;19;180610;3;14;19;21;54
5560;19;170912;9;11;11;28;50
5561;19;180711;11;14;7;31;52
5562;19;170913;9;20;7;31;58
5563;19;180809;2;5;9;24;38
5564;19;181011;9;6;20;43;69
5565;19;170914;9;19;16;48;83
5566;19;180214;1;8;15;18;41
5567;19;180316;4;17;6;33;56
5568;19;170915;9;9;14;54;77
5569;19;151309;11;12;20;9;41
5570;19;151407;2;20;13;29;62
5571;19;180510;10;8;6;35;49
5572;19;151509;2;9;13;27;49
5573;19;151310;11;7;9;21;37
5574;19;180215;1;7;12;24;43
5575;19;180611;3;14;7;36;57
5576;19;180712;11;7;11;55;73
5577;19;180810;2;20;11;5;36
5578;19;181012;9;10;15;12;37
5579;19;180417;2;19;6;49;74
5580;19;151408;2;9;7;39;55
5581;19;181013;9;10;15;51;76
5582;19;151510;2;11;11;17;39
5583;19;151311;11;19;19;5;43
5584;19;180811;2;8;12;25;45
5585;19;180511;10;13;13;29;55
5586;19;151409;2;7;16;5;28
5587;19;180612;3;7;10;38;55
5588;19;170916;9;9;12;60;81
5589;19;180713;11;15;15;18;48
5590;19;180812;2;8;16;31;55
5591;19;180118;1;20;5;30;55
5592;19;181014;9;12;20;55;87
5593;19;180418;2;16;12;6;34
5594;19;181015;9;15;17;27;59
5595;19;180613;3;13;13;12;38
5596;19;151410;2;18;20;35;73
5597;19;180714;11;10;17;36;63
5598;19;180813;2;13;8;19;40
5599;19;180317;4;12;16;25;53
5600;19;170917;9;8;17;15;40
5601;19;180512;10;8;18;14;40
5602;19;151312;11;7;11;58;76
5603;19;170918;9;17;7;15;39
5604;19;180216;1;5;13;51;69
5605;19;151411;2;14;6;52;72
5606;19;151511;2;19;9;9;37
5607;19;180419;2;18;12;18;48
5608;19;151512;2;16;9;27;52
5609;19;180614;3;7;14;53;74
5610;19;180715;11;14;12;14;40
5611;19;180513;10;13;10;6;29
5612;19;151313;11;14;16;23;53
5613;19;180615;3;18;8;46;72
5614;19;180716;11;11;19;22;52
5615;19;180814;2;13;17;43;73
5616;19;180318;4;11;16;40;67
5617;19;180616;3;13;5;11;29
5618;19;181016;9;15;5;54;74
5619;19;180119;1;5;17;28;50
5620;19;151412;2;14;8;41;63
5621;19;180420;2;6;6;37;49
5622;19;180319;4;5;19;59;83
5623;19;180717;11;9;6;15;30
5624;19;151413;2;14;5;45;64
5625;19;180815;2;11;10;10;31
5626;19;151513;2;19;9;51;79
5627;19;181017;9;14;10;6;30
5628;19;181018;9;10;12;21;43
5629;19;151514;2;8;7;51;66
5630;19;180120;1;9;9;54;72
5631;19;180617;3;8;11;19;38
5632;19;180718;11;12;8;26;46
5633;19;180816;2;17;8;14;39
5634;19;180514;10;20;8;26;54
5635;19;180421;2;12;10;6;28
5636;19;180618;3;17;18;22;57
5637;19;151515;2;16;10;19;45
5638;19;151314;11;20;16;22;58
5639;19;180217;1;7;5;13;25
5640;19;180320;4;19;5;35;59
5641;19;180121;1;20;14;7;41
5642;19;181019;9;18;19;36;73
5643;19;151414;2;10;19;42;71
5644;19;180122;1;17;11;26;54
5645;19;180218;1;16;12;35;63
5646;19;180515;10;10;19;28;57
5647;19;180321;4;6;16;48;70
5648;19;180219;1;6;6;28;40
5649;19;180422;2;11;20;38;69
5650;19;180719;11;9;17;43;69
5651;19;180817;2;11;6;43;60
5652;19;181020;9;14;17;38;69
5653;19;180220;1;8;5;53;66
5654;19;181021;9;5;10;55;70
5655;19;151415;2;9;8;15;32
5656;19;180322;4;16;6;50;72
5657;19;180516;10;10;8;39;57
5658;19;180619;3;11;11;16;38
5659;19;180720;11;7;9;60;76
5660;19;180818;2;8;11;27;46
5661;19;181022;9;11;7;30;48
5662;19;180819;2;19;19;15;53
5663;19;151315;11;6;6;30;42
5664;19;180517;10;17;12;46;75
5665;19;151416;2;17;12;17;46
5666;19;180518;10;11;18;42;71
5667;19;151516;2;6;12;29;47
5668;19;180423;2;15;13;9;37
5669;19;151316;11;17;6;42;65
5670;19;151417;2;19;12;44;75
5671;19;180221;1;13;5;14;32
5672;19;151517;2;18;9;41;68
5673;19;180323;4;15;12;27;54
5674;19;180820;2;5;9;25;39
5675;19;180222;1;7;5;55;67
5676;19;181023;9;20;6;38;64
5677;19;181024;9;7;14;34;55
5678;19;180821;2;17;19;16;52
5679;19;151317;11;11;10;48;69
5680;19;180519;10;12;16;49;77
5681;19;180123;1;6;12;32;50
5682;19;180620;3;5;17;48;70
5683;19;180424;2;9;9;59;77
5684;19;180223;1;8;5;58;71
5685;19;180721;11;9;9;32;50
5686;19;180324;4;15;15;54;84
5687;19;180520;10;18;10;20;48
5688;19;180822;2;15;19;59;93
5689;19;181025;9;8;10;6;24
5690;19;151418;2;16;12;9;37
5691;19;180224;1;15;9;10;34
5692;19;180722;11;7;12;38;57
5693;19;180425;2;19;18;40;77
5694;19;180521;10;20;20;57;97
5695;19;180621;3;10;8;9;27
5696;19;180124;1;9;5;17;31
5697;19;180325;4;15;10;32;57
5698;19;151419;2;15;20;34;69
5699;19;180723;11;10;7;36;53
5700;19;180823;2;6;5;35;46
5701;19;180125;1;13;6;39;58
5702;19;151518;2;18;11;16;45
5703;19;180522;10;11;19;8;38
5704;19;180622;3;14;19;14;47
5705;19;180523;10;16;9;48;73
5706;19;180225;1;9;16;39;64
5707;19;180524;10;5;7;56;68
5708;19;180126;1;15;14;37;66
5709;19;180326;4;10;16;54;80
5710;19;180724;11;18;20;34;72
5711;19;151318;11;16;10;20;46
5712;19;180127;1;13;13;47;73
5713;19;180426;2;11;20;23;54
5714;19;180824;2;14;20;11;45
5715;19;180825;2;6;9;57;72
5716;19;180525;10;13;19;9;41
5717;19;180526;10;16;12;26;54
5718;19;180623;3;11;5;58;74
5719;19;180624;3;7;16;41;64
5720;20;151301;6;17;19;10;46
5721;20;180101;6;17;15;59;91
5722;20;180501;3;8;6;34;48
5723;20;180701;1;9;12;11;32
5724;20;180201;8;5;20;36;61
5725;20;180301;2;10;20;43;73
5726;20;151501;1;16;14;38;68
5727;20;170901;11;8;9;24;41
5728;20;151302;6;14;11;13;38
5729;20;180801;7;6;16;19;41
5730;20;181001;3;11;6;14;31
5731;20;180102;6;8;5;6;19
5732;20;180401;10;19;13;26;58
5733;20;180502;3;11;7;42;60
5734;20;180202;8;9;16;37;62
5735;20;180302;2;15;8;52;75
5736;20;180601;9;6;14;54;74
5737;20;180303;2;17;18;36;71
5738;20;180402;10;17;5;40;62
5739;20;180702;1;7;12;56;75
5740;20;180103;6;11;7;22;40
5741;20;170902;11;13;19;44;76
5742;20;180203;8;14;7;27;48
5743;20;180802;7;20;10;49;79
5744;20;180503;3;8;14;10;32
5745;20;180304;2;5;13;5;23
5746;20;180403;10;20;18;9;47
5747;20;180602;9;17;14;10;41
5748;20;180703;1;15;7;48;70
5749;20;151401;2;17;14;7;38
5750;20;180104;6;13;18;54;85
5751;20;170903;11;11;10;33;54
5752;20;180105;6;12;16;42;70
5753;20;180204;8;16;13;30;59
5754;20;180305;2;7;13;24;44
5755;20;170904;11;15;9;7;31
5756;20;180404;10;11;18;37;66
5757;20;180106;6;13;13;48;74
5758;20;151303;6;18;11;43;72
5759;20;181002;3;17;19;54;90
5760;20;180704;1;12;6;55;73
5761;20;151402;2;14;13;22;49
5762;20;180504;3;17;6;35;58
5763;20;151304;6;5;5;40;50
5764;20;151502;1;6;19;24;49
5765;20;180705;1;7;14;43;64
5766;20;180603;9;9;10;39;58
5767;20;180803;7;9;6;52;67
5768;20;180306;2;19;13;30;62
5769;20;151503;1;19;11;38;68
5770;20;180205;8;13;11;56;80
5771;20;170905;11;9;11;26;46
5772;20;181003;3;12;10;54;76
5773;20;180405;10;14;14;31;59
5774;20;151305;6;17;7;7;31
5775;20;180307;2;12;11;56;79
5776;20;181004;3;18;7;38;63
5777;20;180406;10;13;5;50;68
5778;20;180505;3;17;20;23;60
5779;20;170906;11;9;10;38;57
5780;20;180604;9;5;11;19;35
5781;20;180308;2;11;17;51;79
5782;20;151403;2;17;16;21;54
5783;20;180206;8;14;17;25;56
5784;20;180407;10;11;17;34;62
5785;20;180706;1;8;6;25;39
5786;20;180107;6;16;9;14;39
5787;20;180804;7;13;11;39;63
5788;20;180207;8;17;20;39;76
5789;20;151504;1;13;17;11;41
5790;20;180408;10;15;13;24;52
5791;20;170907;11;17;20;41;78
5792;20;180108;6;14;5;27;46
5793;20;180309;2;13;18;57;88
5794;20;181005;3;9;14;10;33
5795;20;180605;9;12;8;36;56
5796;20;180109;6;13;11;7;31
5797;20;151306;6;6;12;38;56
5798;20;180707;1;11;9;35;55
5799;20;180110;6;19;15;30;64
5800;20;180409;10;14;17;33;64
5801;20;170908;11;14;11;59;84
5802;20;180506;3;10;7;46;63
5803;20;180606;9;10;7;52;69
5804;20;151404;2;13;13;9;35
5805;20;180805;7;10;12;38;60
5806;20;151505;1;13;16;34;63
5807;20;180410;10;14;14;15;43
5808;20;151307;6;15;20;18;53
5809;20;180310;2;20;13;57;90
5810;20;170909;11;20;11;24;55
5811;20;181006;3;10;13;23;46
5812;20;180111;6;14;5;41;60
5813;20;170910;11;6;5;16;27
5814;20;151506;1;20;8;22;50
5815;20;180311;2;9;17;14;40
5816;20;180112;6;14;20;13;47
5817;20;180708;1;8;14;23;45
5818;20;180507;3;17;19;31;67
5819;20;180607;9;18;9;15;42
5820;20;180709;1;13;17;20;50
5821;20;180806;7;7;10;44;61
5822;20;181007;3;8;16;23;47
5823;20;180411;10;11;17;56;84
5824;20;180208;8;13;16;16;45
5825;20;180312;2;9;6;38;53
5826;20;180412;10;17;15;6;38
5827;20;180113;6;8;13;5;26
5828;20;181008;3;12;14;17;43
5829;20;180508;3;12;17;59;88
5830;20;151308;6;9;13;10;32
5831;20;151405;2;7;17;18;42
5832;20;180608;9;18;5;38;61
5833;20;151507;1;17;7;36;60
5834;20;180209;8;20;8;49;77
5835;20;180313;2;19;11;31;61
5836;20;180413;10;5;12;24;41
5837;20;180114;6;10;6;40;56
5838;20;180210;8;6;17;10;33
5839;20;180710;1;11;14;14;39
5840;20;180807;7;5;16;60;81
5841;20;180211;8;6;6;12;24
5842;20;180115;6;17;14;48;79
5843;20;180212;8;20;8;28;56
5844;20;180414;10;12;15;56;83
5845;20;180314;2;9;11;16;36
5846;20;180213;8;11;13;34;58
5847;20;181009;3;5;11;45;61
5848;20;180509;3;13;20;18;51
5849;20;180808;7;15;17;23;55
5850;20;180415;10;18;18;13;49
5851;20;180609;9;6;11;55;72
5852;20;151406;2;5;11;21;37
5853;20;151508;1;20;15;59;94
5854;20;180116;6;18;5;36;59
5855;20;180315;2;16;18;59;93
5856;20;181010;3;15;18;6;39
5857;20;180416;10;5;14;20;39
5858;20;180117;6;18;17;5;40
5859;20;170911;11;18;14;47;79
5860;20;180610;9;14;7;9;30
5861;20;170912;11;13;20;24;57
5862;20;180711;1;12;6;54;72
5863;20;170913;11;12;14;57;83
5864;20;180809;7;11;12;10;33
5865;20;181011;3;9;8;60;77
5866;20;170914;11;14;12;51;77
5867;20;180214;8;18;10;22;50
5868;20;180316;2;10;5;38;53
5869;20;170915;11;6;8;40;54
5870;20;151309;6;16;7;22;45
5871;20;151407;2;20;9;12;41
5872;20;180510;3;12;17;27;56
5873;20;151509;1;17;13;47;77
5874;20;151310;6;12;13;34;59
5875;20;180215;8;14;12;31;57
5876;20;180611;9;20;10;28;58
5877;20;180712;1;12;5;48;65
5878;20;180810;7;18;19;59;96
5879;20;181012;3;20;18;6;44
5880;20;180417;10;11;12;30;53
5881;20;151408;2;10;5;30;45
5882;20;181013;3;15;18;17;50
5883;20;151510;1;12;14;9;35
5884;20;151311;6;17;8;33;58
5885;20;180811;7;14;8;26;48
5886;20;180511;3;14;7;59;80
5887;20;151409;2;8;14;44;66
5888;20;180612;9;20;13;18;51
5889;20;170916;11;17;10;21;48
5890;20;180713;1;20;13;33;66
5891;20;180812;7;5;10;27;42
5892;20;180118;6;9;11;27;47
5893;20;181014;3;19;17;33;69
5894;20;180418;10;16;13;57;86
5895;20;181015;3;19;16;44;79
5896;20;180613;9;12;15;38;65
5897;20;151410;2;5;17;24;46
5898;20;180714;1;10;11;28;49
5899;20;180813;7;11;15;8;34
5900;20;180317;2;17;9;33;59
5901;20;170917;11;8;19;16;43
5902;20;180512;3;20;9;24;53
5903;20;151312;6;16;19;22;57
5904;20;170918;11;9;5;43;57
5905;20;180216;8;7;8;27;42
5906;20;151411;2;10;10;46;66
5907;20;151511;1;11;19;7;37
5908;20;180419;10;7;19;41;67
5909;20;151512;1;19;14;56;89
5910;20;180614;9;15;16;21;52
5911;20;180715;1;8;15;25;48
5912;20;180513;3;10;13;16;39
5913;20;151313;6;11;6;19;36
5914;20;180615;9;15;19;52;86
5915;20;180716;1;8;7;14;29
5916;20;180814;7;17;19;56;92
5917;20;180318;2;15;15;15;45
5918;20;180616;9;14;17;60;91
5919;20;181016;3;19;13;12;44
5920;20;180119;6;12;7;58;77
5921;20;151412;2;5;12;27;44
5922;20;180420;10;12;11;10;33
5923;20;180319;2;7;13;22;42
5924;20;180717;1;10;18;47;75
5925;20;151413;2;6;5;15;26
5926;20;180815;7;9;12;42;63
5927;20;151513;1;8;14;5;27
5928;20;181017;3;6;13;49;68
5929;20;181018;3;8;17;47;72
5930;20;151514;1;19;18;15;52
5931;20;180120;6;15;11;12;38
5932;20;180617;9;13;12;27;52
5933;20;180718;1;20;12;48;80
5934;20;180816;7;10;9;37;56
5935;20;180514;3;6;7;25;38
5936;20;180421;10;18;8;50;76
5937;20;180618;9;7;6;56;69
5938;20;151515;1;19;11;44;74
5939;20;151314;6;16;19;54;89
5940;20;180217;8;20;16;36;72
5941;20;180320;2;19;6;23;48
5942;20;180121;6;11;10;51;72
5943;20;181019;3;19;14;55;88
5944;20;151414;2;20;8;60;88
5945;20;180122;6;19;12;22;53
5946;20;180218;8;20;12;15;47
5947;20;180515;3;14;8;27;49
5948;20;180321;2;18;17;36;71
5949;20;180219;8;8;12;44;64
5950;20;180422;10;20;11;54;85
5951;20;180719;1;13;9;56;78
5952;20;180817;7;17;19;58;94
5953;20;181020;3;12;18;50;80
5954;20;180220;8;17;6;42;65
5955;20;181021;3;18;20;43;81
5956;20;151415;2;16;10;26;52
5957;20;180322;2;20;18;54;92
5958;20;180516;3;10;15;32;57
5959;20;180619;9;5;17;40;62
5960;20;180720;1;20;10;39;69
5961;20;180818;7;10;10;57;77
5962;20;181022;3;5;8;48;61
5963;20;180819;7;7;17;39;63
5964;20;151315;6;20;5;53;78
5965;20;180517;3;12;15;31;58
5966;20;151416;2;12;18;40;70
5967;20;180518;3;11;14;10;35
5968;20;151516;1;16;12;22;50
5969;20;180423;10;8;17;15;40
5970;20;151316;6;6;17;12;35
5971;20;151417;2;10;17;9;36
5972;20;180221;8;14;19;11;44
5973;20;151517;1;6;6;57;69
5974;20;180323;2;13;5;55;73
5975;20;180820;7;8;19;30;57
5976;20;180222;8;13;19;14;46
5977;20;181023;3;19;15;29;63
5978;20;181024;3;9;14;15;38
5979;20;180821;7;20;14;30;64
5980;20;151317;6;8;12;24;44
5981;20;180519;3;12;13;43;68
5982;20;180123;6;12;11;48;71
5983;20;180620;9;8;17;29;54
5984;20;180424;10;9;8;48;65
5985;20;180223;8;10;9;49;68
5986;20;180721;1;12;5;36;53
5987;20;180324;2;16;6;13;35
5988;20;180520;3;20;20;58;98
5989;20;180822;7;13;11;8;32
5990;20;181025;3;19;9;49;77
5991;20;151418;2;11;18;44;73
5992;20;180224;8;9;20;25;54
5993;20;180722;1;17;8;50;75
5994;20;180425;10;7;20;59;86
5995;20;180521;3;19;14;52;85
5996;20;180621;9;20;12;60;92
5997;20;180124;6;18;5;59;82
5998;20;180325;2;7;11;19;37
5999;20;151419;2;19;15;31;65
6000;20;180723;1;8;20;52;80
6001;20;180823;7;20;17;49;86
6002;20;180125;6;8;9;60;77
6003;20;151518;1;7;7;56;70
6004;20;180522;3;18;10;58;86
6005;20;180622;9;17;10;41;68
6006;20;180523;3;5;17;56;78
6007;20;180225;8;20;18;27;65
6008;20;180524;3;8;20;49;77
6009;20;180126;6;7;18;8;33
6010;20;180326;2;11;5;33;49
6011;20;180724;1;13;8;24;45
6012;20;151318;6;5;16;7;28
6013;20;180127;6;18;10;19;47
6014;20;180426;10;15;13;42;70
6015;20;180824;7;14;16;9;39
6016;20;180825;7;6;17;50;73
6017;20;180525;3;18;17;9;44
6018;20;180526;3;10;18;8;36
6019;20;180623;9;14;16;34;64
6020;20;180624;9;17;9;32;58